name,orf_name,chr,start,stop,length,strand,orf_class
YAL069W,YAL069W,1,335,649,314,+,Dubious
YAL068W-A,YAL068W-A,1,538,792,254,+,Dubious
PAU8,YAL068C,1,1807,2169,362,-,Uncharacterized
YAL067W-A,YAL067W-A,1,2480,2707,227,+,Uncharacterized
SEO1,YAL067C,1,7236,9017,1781,-,Verified
YAL066W,YAL066W,1,10092,10400,308,+,Dubious
YAL065C,YAL065C,1,11566,11952,386,-,Uncharacterized
YAL064W-B,YAL064W-B,1,12047,12427,380,+,Uncharacterized
YAL064C-A,YAL064C-A,1,13364,13744,380,-,Uncharacterized
YAL064W,YAL064W,1,21526,21852,326,+,Verified
YAL063C-A,YAL063C-A,1,22397,22687,290,-,Uncharacterized
FLO9,YAL063C,1,24001,27969,3968,-,Verified
GDH3,YAL062W,1,31568,32941,1373,+,Verified
BDH2,YAL061W,1,33449,34702,1253,+,Uncharacterized
BDH1,YAL060W,1,35156,36304,1148,+,Verified
YAL059C-A,YAL059C-A,1,36497,36919,422,-,Dubious
ECM1,YAL059W,1,36510,37148,638,+,Verified
CNE1,YAL058W,1,37465,38973,1508,+,Verified
YAL056C-A,YAL056C-A,1,38697,39047,350,-,Dubious
GPB2,YAL056W,1,39260,41902,2642,+,Verified
PEX22,YAL055W,1,42178,42720,542,+,Verified
ACS1,YAL054C,1,42882,45023,2141,-,Verified
FLC2,YAL053W,1,45900,48251,2351,+,Verified
OAF1,YAL051W,1,48565,51708,3143,+,Verified
AIM2,YAL049C,1,51856,52596,740,-,Uncharacterized
GEM1,YAL048C,1,52802,54790,1988,-,Verified
YAL047W-A,YAL047W-A,1,54585,54914,329,+,Dubious
SPC72,YAL047C,1,54990,56858,1868,-,Verified
AIM1,YAL046C,1,57030,57386,356,-,Uncharacterized
YAL045C,YAL045C,1,57489,57797,308,-,Dubious
YAL044W-A,YAL044W-A,1,57519,57851,332,+,Uncharacterized
GCV3,YAL044C,1,57951,58463,512,-,Verified
PTA1,YAL043C,1,58696,61053,2357,-,Verified
YAL042C-A,YAL042C-A,1,61232,61609,377,-,Dubious
ERV46,YAL042W,1,61317,62564,1247,+,Verified
CDC24,YAL041W,1,62841,65405,2564,+,Verified
CLN3,YAL040C,1,65779,67521,1742,-,Verified
CYC3,YAL039C,1,68717,69526,809,-,Verified
CDC19,YAL038W,1,71787,73289,1502,+,Verified
YAL037C-B,YAL037C-B,1,72327,73301,974,-,Dubious
YAL037C-A,YAL037C-A,1,73427,73519,92,-,Uncharacterized
YAL037W,YAL037W,1,74021,74824,803,+,Uncharacterized
RBG1,YAL036C,1,75044,76153,1109,-,Verified
FUN12,YAL035W,1,76428,79436,3008,+,Verified
YAL034C-B,YAL034C-B,1,79490,79843,353,-,Dubious
MTW1,YAL034W-A,1,79719,80588,869,+,Verified
FUN19,YAL034C,1,80711,81952,1241,-,Verified
POP5,YAL033W,1,82707,83228,521,+,Verified
PRP45,YAL032C,1,83336,84475,1139,-,Verified
YAL031W-A,YAL031W-A,1,84670,84978,308,+,Dubious
GIP4,YAL031C,1,84750,87032,2282,-,Verified
SNC1,YAL030W,1,87287,87753,466,+,Verified
MYO4,YAL029C,1,87856,92271,4415,-,Verified
FRT2,YAL028W,1,92901,94487,1586,+,Verified
SAW1,YAL027W,1,94688,95473,785,+,Verified
YAL026C-A,YAL026C-A,1,95387,95824,437,-,Dubious
DRS2,YAL026C,1,95631,99698,4067,-,Verified
MAK16,YAL025C,1,100226,101146,920,-,Verified
LTE1,YAL024C,1,101566,105873,4307,-,Verified
PMT2,YAL023C,1,106273,108552,2279,-,Verified
FUN26,YAL022C,1,108878,110431,1553,-,Verified
CCR4,YAL021C,1,110847,113360,2513,-,Verified
ATS1,YAL020C,1,113615,114616,1001,-,Verified
YAL019W-A,YAL019W-A,1,114251,114820,569,+,Dubious
FUN30,YAL019W,1,114920,118315,3395,+,Verified
YAL018C,YAL018C,1,118565,119542,977,-,Uncharacterized
PSK1,YAL017W,1,120226,124296,4070,+,Verified
YAL016C-B,YAL016C-B,1,124308,124493,185,-,Dubious
YAL016C-A,YAL016C-A,1,124756,125070,314,-,Dubious
TPD3,YAL016W,1,124880,126787,1907,+,Verified
NTG1,YAL015C,1,126904,128103,1199,-,Verified
SYN8,YAL014C,1,128253,129020,767,-,Verified
DEP1,YAL013W,1,129271,130533,1262,+,Verified
CYS3,YAL012W,1,130802,131986,1184,+,Verified
SWC3,YAL011W,1,132202,134079,1877,+,Verified
MDM10,YAL010C,1,134186,135667,1481,-,Verified
SPO7,YAL009W,1,135856,136635,779,+,Verified
FUN14,YAL008W,1,136916,137512,596,+,Verified
ERP2,YAL007C,1,137700,138347,647,-,Verified
SSA1,YAL005C,1,139505,141433,1928,-,Verified
YAL004W,YAL004W,1,140762,141409,647,+,Dubious
EFB1,YAL003W,1,142176,143162,986,+,Verified
VPS8,YAL002W,1,143709,147533,3824,+,Verified
TFC3,YAL001C,1,147596,151168,3572,-,Verified
NUP60,YAR002W,1,152259,153878,1619,+,Verified
ERP1,YAR002C-A,1,154067,154726,659,-,Verified
SWD1,YAR003W,1,155007,156287,1280,+,Verified
RFA1,YAR007C,1,156756,158621,1865,-,Verified
SEN34,YAR008W,1,158967,159794,827,+,Verified
BUD14,YAR014C,1,166743,168866,2123,-,Verified
ADE1,YAR015W,1,169370,170290,920,+,Verified
KIN3,YAR018C,1,170391,171698,1307,-,Verified
CDC15,YAR019C,1,172209,175133,2924,-,Verified
YAR019W-A,YAR019W-A,1,174996,175340,344,+,Dubious
PAU7,YAR020C,1,176854,177021,167,-,Verified
YAR023C,YAR023C,1,179279,179818,539,-,Uncharacterized
UIP3,YAR027W,1,183764,184471,707,+,Verified
YAR028W,YAR028W,1,184886,185590,704,+,Uncharacterized
YAR029W,YAR029W,1,186315,186539,224,+,Uncharacterized
YAR030C,YAR030C,1,186506,186847,341,-,Dubious
PRM9,YAR031W,1,186830,187726,896,+,Verified
MST28,YAR033W,1,188101,188805,704,+,Verified
YAT1,YAR035W,1,190187,192250,2063,+,Verified
YAR035C-A,YAR035C-A,1,192331,192411,80,-,Uncharacterized
SWH1,YAR042W,1,192613,196179,3566,+,Verified
YAR047C,YAR047C,1,201460,201780,320,-,Dubious
FLO1,YAR050W,1,203394,208007,4613,+,Verified
YAR053W,YAR053W,1,208358,208654,296,+,Dubious
YAR060C,YAR060C,1,217148,217483,335,-,Dubious
YAR064W,YAR064W,1,220189,220488,299,+,Uncharacterized
YAR066W,YAR066W,1,221040,221651,611,+,Uncharacterized
YAR068W,YAR068W,1,222397,222882,485,+,Uncharacterized
YAR069C,YAR069C,1,224002,224295,293,-,Dubious
YAR070C,YAR070C,1,224554,224853,299,-,Dubious
PHO11,YAR071W,1,225451,226854,1403,+,Verified
IMD1,YAR073W,1,227733,228944,1211,+,Dubious
YAR075W,YAR075W,1,228835,229308,473,+,Dubious
YBL113C,YBL113C,2,280,2658,2378,-,Uncharacterized
YBL113W-A,YBL113W-A,2,646,1128,482,+,Dubious
YBL112C,YBL112C,2,2582,2899,317,-,Uncharacterized
YBL111C,YBL111C,2,2907,5009,2102,-,Uncharacterized
YBL109W,YBL109W,2,5790,6125,335,+,Dubious
PAU9,YBL108C-A,2,7605,7733,128,-,Uncharacterized
YBL108W,YBL108W,2,8177,8482,305,+,Dubious
YBL107W-A,YBL107W-A,2,9268,9372,104,+,Dubious
YBL107C,YBL107C,2,9961,10551,590,-,Uncharacterized
SRO77,YBL106C,2,10847,13879,3032,-,Verified
PKC1,YBL105C,2,14241,17696,3455,-,Verified
YBL104C,YBL104C,2,18177,21293,3116,-,Uncharacterized
RTG3,YBL103C,2,22075,23535,1460,-,Verified
SFT2,YBL102W,2,24098,24745,647,+,Verified
ECM21,YBL101C,2,24946,28299,3353,-,Verified
YBL100W-C,YBL100W-C,2,28427,28546,119,+,Uncharacterized
YBL100C,YBL100C,2,36986,37300,314,-,Dubious
ATP1,YBL099W,2,37050,38687,1637,+,Verified
BNA4,YBL098W,2,39142,40524,1382,+,Verified
BRN1,YBL097W,2,40828,43092,2264,+,Verified
YBL096C,YBL096C,2,43171,43479,308,-,Dubious
YBL095W,YBL095W,2,43274,44086,812,+,Uncharacterized
YBL094C,YBL094C,2,43762,44094,332,-,Dubious
ROX3,YBL093C,2,44253,44915,662,-,Verified
RPL32,YBL092W,2,45642,46367,725,+,Verified
SCS22,YBL091C-A,2,46562,47177,615,-,Verified
MAP2,YBL091C,2,47360,48625,1265,-,Verified
MRP21,YBL090W,2,48822,49355,533,+,Verified
AVT5,YBL089W,2,49571,50950,1379,+,Verified
TEL1,YBL088C,2,51016,59379,8363,-,Verified
RPL23A,YBL087C,2,59818,60735,917,-,Verified
YBL086C,YBL086C,2,61199,62599,1400,-,Uncharacterized
BOI1,YBL085W,2,63873,66815,2942,+,Verified
CDC27,YBL084C,2,67166,69442,2276,-,Verified
YBL083C,YBL083C,2,69710,70135,425,-,Dubious
ALG3,YBL082C,2,69748,71124,1376,-,Verified
YBL081W,YBL081W,2,71863,72969,1106,+,Uncharacterized
PET112,YBL080C,2,73067,74692,1625,-,Verified
NUP170,YBL079W,2,75256,79764,4508,+,Verified
ATG8,YBL078C,2,80375,80728,353,-,Verified
YBL077W,YBL077W,2,80895,81326,431,+,Dubious
ILS1,YBL076C,2,81041,84259,3218,-,Verified
SSA3,YBL075C,2,84497,86446,1949,-,Verified
AAR2,YBL074C,2,86720,87787,1067,-,Verified
YBL073W,YBL073W,2,87644,87955,311,+,Dubious
RPS8A,YBL072C,2,88521,89438,917,-,Verified
YBL071C-B,YBL071C-B,2,89456,89554,98,-,Uncharacterized
KTI11,YBL071W-A,2,89976,90224,248,+,Verified
YBL071C,YBL071C,2,90221,90529,308,-,Dubious
YBL070C,YBL070C,2,90603,90923,320,-,Dubious
AST1,YBL069W,2,90739,92028,1289,+,Verified
YBL068W-A,YBL068W-A,2,91792,92028,236,+,Dubious
PRS4,YBL068W,2,92412,93395,983,+,Verified
UBP13,YBL067C,2,93641,95884,2243,-,Verified
SEF1,YBL066C,2,96671,100117,3446,-,Verified
YBL065W,YBL065W,2,99965,100309,344,+,Dubious
PRX1,YBL064C,2,100373,101158,785,-,Verified
KIP1,YBL063W,2,101888,105223,3335,+,Verified
YBL062W,YBL062W,2,105310,105690,380,+,Dubious
SKT5,YBL061C,2,105318,107408,2090,-,Verified
YEL1,YBL060W,2,107934,109997,2063,+,Uncharacterized
YBL059C-A,YBL059C-A,2,110127,110541,414,-,Uncharacterized
YBL059W,YBL059W,2,110596,111246,650,+,Uncharacterized
SHP1,YBL058W,2,111439,112710,1271,+,Verified
PTH2,YBL057C,2,112803,113447,644,-,Verified
PTC3,YBL056W,2,113765,115171,1406,+,Verified
YBL055C,YBL055C,2,115576,116832,1256,-,Verified
YBL054W,YBL054W,2,117592,119169,1577,+,Uncharacterized
YBL053W,YBL053W,2,119338,119712,374,+,Dubious
SAS3,YBL052C,2,119382,121877,2495,-,Verified
PIN4,YBL051C,2,122756,124762,2006,-,Verified
SEC17,YBL050W,2,125128,126122,994,+,Verified
MOH1,YBL049W,2,126831,127247,416,+,Verified
YBL048W,YBL048W,2,127302,127613,311,+,Dubious
EDE1,YBL047C,2,127898,132043,4145,-,Verified
PSY4,YBL046W,2,132427,133752,1325,+,Verified
COR1,YBL045C,2,134146,135519,1373,-,Verified
YBL044W,YBL044W,2,136001,136369,368,+,Uncharacterized
ECM13,YBL043W,2,136691,137464,773,+,Verified
FUI1,YBL042C,2,138344,140263,1919,-,Verified
PRE7,YBL041W,2,141250,141975,725,+,Verified
ERD2,YBL040C,2,142115,142871,756,-,Verified
YBL039W-B,YBL039W-B,2,143396,143575,179,+,Uncharacterized
URA7,YBL039C,2,143992,145731,1739,-,Verified
YBL039C-A,YBL039C-A,2,144951,145034,83,-,Dubious
MRPL16,YBL038W,2,146190,146888,698,+,Verified
APL3,YBL037W,2,147212,150289,3077,+,Verified
YBL036C,YBL036C,2,150450,151223,773,-,Verified
POL12,YBL035C,2,151496,153613,2117,-,Verified
STU1,YBL034C,2,153851,158392,4541,-,Verified
RIB1,YBL033C,2,158659,159696,1037,-,Verified
HEK2,YBL032W,2,160187,161332,1145,+,Verified
SHE1,YBL031W,2,161702,162718,1016,+,Verified
PET9,YBL030C,2,163044,164000,956,-,Verified
YBL029C-A,YBL029C-A,2,164491,164775,284,-,Uncharacterized
YBL029W,YBL029W,2,166137,167267,1130,+,Uncharacterized
YBL028C,YBL028C,2,167521,167841,320,-,Verified
RPL19B,YBL027W,2,168426,169379,953,+,Verified
LSM2,YBL026W,2,170626,171041,415,+,Verified
RRN10,YBL025W,2,171484,171921,437,+,Verified
NCL1,YBL024W,2,172537,174591,2054,+,Verified
MCM2,YBL023C,2,174923,177529,2606,-,Verified
PIM1,YBL022C,2,177877,181278,3401,-,Verified
HAP3,YBL021C,2,181663,182097,434,-,Verified
RFT1,YBL020W,2,182404,184128,1724,+,Verified
APN2,YBL019W,2,184356,185918,1562,+,Verified
POP8,YBL018C,2,186001,186477,476,-,Verified
PEP1,YBL017C,2,186847,191586,4739,-,Verified
FUS3,YBL016W,2,192454,193515,1061,+,Verified
ACH1,YBL015W,2,194125,195705,1580,+,Verified
RRN6,YBL014C,2,199067,201751,2684,-,Verified
FMT1,YBL013W,2,202059,203264,1205,+,Verified
YBL012C,YBL012C,2,203409,203810,401,-,Dubious
SCT1,YBL011W,2,203541,205820,2279,+,Verified
YBL010C,YBL010C,2,206110,206952,842,-,Uncharacterized
ALK2,YBL009W,2,207197,209227,2030,+,Verified
YBL008W-A,YBL008W-A,2,209412,209651,239,+,Uncharacterized
HIR1,YBL008W,2,209656,212178,2522,+,Verified
SLA1,YBL007C,2,212635,216369,3734,-,Verified
LDB7,YBL006C,2,216590,217132,542,-,Verified
YBL006W-A,YBL006W-A,2,216714,216863,149,+,Dubious
PDR3,YBL005W,2,217473,220403,2930,+,Verified
UTP20,YBL004W,2,227639,235120,7481,+,Verified
HTA2,YBL003C,2,235397,235795,398,-,Verified
HTB2,YBL002W,2,236495,236890,395,+,Verified
ECM15,YBL001C,2,237155,237469,314,-,Verified
NTH2,YBR001C,2,238943,241285,2342,-,Verified
RER2,YBR002C,2,241710,242570,860,-,Verified
COQ1,YBR003W,2,242811,244232,1421,+,Verified
GPI18,YBR004C,2,244368,245669,1301,-,Verified
RCR1,YBR005W,2,245908,246549,641,+,Verified
UGA2,YBR006W,2,247012,248505,1493,+,Verified
DSF2,YBR007C,2,248807,251017,2210,-,Uncharacterized
FLR1,YBR008C,2,252564,254210,1646,-,Verified
HHF1,YBR009C,2,255371,255682,311,-,Verified
HHT1,YBR010W,2,256329,256739,410,+,Verified
IPP1,YBR011C,2,257110,257973,863,-,Verified
YBR012C,YBR012C,2,259145,259564,419,-,Dubious
YBR013C,YBR013C,2,265490,265879,389,-,Uncharacterized
GRX7,YBR014C,2,266725,267336,611,-,Verified
MNN2,YBR015C,2,267710,269503,1793,-,Verified
YBR016W,YBR016W,2,270247,270633,386,+,Uncharacterized
KAP104,YBR017C,2,270947,273703,2756,-,Verified
GAL7,YBR018C,2,274427,275527,1100,-,Verified
GAL10,YBR019C,2,276253,278352,2099,-,Verified
GAL1,YBR020W,2,279021,280607,1586,+,Verified
FUR4,YBR021W,2,281443,283344,1901,+,Verified
POA1,YBR022W,2,283738,284271,533,+,Verified
CHS3,YBR023C,2,284428,287925,3497,-,Verified
SCO2,YBR024W,2,289445,290350,905,+,Verified
OLA1,YBR025C,2,290681,291865,1184,-,Verified
ETR1,YBR026C,2,292877,294019,1142,-,Verified
YBR027C,YBR027C,2,294024,294356,332,-,Dubious
YBR028C,YBR028C,2,294425,296002,1577,-,Uncharacterized
CDS1,YBR029C,2,296369,297742,1373,-,Verified
YBR030W,YBR030W,2,298292,299950,1658,+,Uncharacterized
RPL4A,YBR031W,2,300166,301254,1088,+,Verified
YBR032W,YBR032W,2,301519,301821,302,+,Dubious
EDS1,YBR033W,2,301944,304703,2759,+,Uncharacterized
HMT1,YBR034C,2,304930,305976,1046,-,Verified
PDX3,YBR035C,2,306269,306955,686,-,Verified
CSG2,YBR036C,2,309081,310313,1232,-,Verified
SCO1,YBR037C,2,310564,311451,887,-,Verified
CHS2,YBR038W,2,311897,314788,2891,+,Verified
ATP3,YBR039W,2,315575,316510,935,+,Verified
FIG1,YBR040W,2,316968,317864,896,+,Verified
FAT1,YBR041W,2,318266,320275,2009,+,Verified
CST26,YBR042C,2,320416,321609,1193,-,Verified
QDR3,YBR043C,2,321876,323945,2069,-,Verified
TCM62,YBR044C,2,324337,326058,1721,-,Verified
GIP1,YBR045C,2,328369,330090,1721,-,Verified
ZTA1,YBR046C,2,330505,331509,1004,-,Verified
FMP23,YBR047W,2,331831,332358,527,+,Uncharacterized
RPS11B,YBR048W,2,332829,333810,981,+,Verified
REB1,YBR049C,2,334384,336816,2432,-,Verified
REG2,YBR050C,2,337181,338197,1016,-,Verified
YBR051W,YBR051W,2,337986,338336,350,+,Dubious
RFS1,YBR052C,2,338718,339350,632,-,Verified
YBR053C,YBR053C,2,339673,340749,1076,-,Uncharacterized
YRO2,YBR054W,2,343099,344133,1034,+,Verified
PRP6,YBR055C,2,344600,347299,2699,-,Verified
YBR056W,YBR056W,2,347877,349382,1505,+,Uncharacterized
YBR056W-A,YBR056W-A,2,351253,351453,200,+,Dubious
YBR056C-B,YBR056C-B,2,351291,351449,158,-,Dubious
MUM2,YBR057C,2,352191,353291,1100,-,Verified
UBP14,YBR058C,2,353670,356015,2345,-,Verified
TSC3,YBR058C-A,2,356322,356564,242,-,Verified
AKL1,YBR059C,2,356859,360185,3326,-,Verified
ORC2,YBR060C,2,360650,362512,1862,-,Verified
TRM7,YBR061C,2,364785,365717,932,-,Verified
YBR062C,YBR062C,2,365974,366598,624,-,Uncharacterized
YBR063C,YBR063C,2,366968,368182,1214,-,Uncharacterized
YBR064W,YBR064W,2,367761,368189,428,+,Dubious
ECM2,YBR065C,2,368582,369676,1094,-,Verified
NRG2,YBR066C,2,370035,370697,662,-,Verified
TIP1,YBR067C,2,372100,372732,632,-,Verified
BAP2,YBR068C,2,373858,375687,1829,-,Verified
TAT1,YBR069C,2,376571,378430,1859,-,Verified
ALG14,YBR070C,2,379218,379931,713,-,Verified
YBR071W,YBR071W,2,380408,381043,635,+,Uncharacterized
HSP26,YBR072W,2,382027,382671,644,+,Verified
YBR072C-A,YBR072C-A,2,382855,383016,161,-,Uncharacterized
RDH54,YBR073W,2,383209,385983,2774,+,Verified
YBR074W,YBR074W,2,386281,389211,2930,+,Uncharacterized
ECM8,YBR076W,2,390369,391388,1019,+,Verified
YBR076C-A,YBR076C-A,2,391345,391611,266,-,Dubious
SLM4,YBR077C,2,391799,392287,488,-,Verified
ECM33,YBR078W,2,393118,394854,1736,+,Verified
RPG1,YBR079C,2,395377,398271,2894,-,Verified
SEC18,YBR080C,2,398608,400884,2276,-,Verified
SPT7,YBR081C,2,401247,405245,3998,-,Verified
UBC4,YBR082C,2,406622,407163,541,-,Verified
TEC1,YBR083W,2,409163,410623,1460,+,Verified
MIS1,YBR084W,2,411048,413975,2927,+,Verified
RPL19A,YBR084C-A,2,414180,415255,1075,-,Verified
AAC3,YBR085W,2,415977,416900,923,+,Verified
YBR085C-A,YBR085C-A,2,418901,419158,257,-,Uncharacterized
IST2,YBR086C,2,420195,423035,2840,-,Verified
RFC5,YBR087W,2,423759,424823,1064,+,Verified
POL30,YBR088C,2,424984,425760,776,-,Verified
YBR089W,YBR089W,2,425177,425776,599,+,Dubious
NHP6B,YBR089C-A,2,426184,426867,683,-,Verified
YBR090C,YBR090C,2,426327,427052,725,-,Uncharacterized
MRS5,YBR091C,2,427149,427478,329,-,Verified
PHO3,YBR092C,2,427692,429095,1403,-,Verified
PHO5,YBR093C,2,429542,430945,1403,-,Verified
PBY1,YBR094W,2,432030,434291,2261,+,Verified
RXT2,YBR095C,2,434400,435692,1292,-,Verified
YBR096W,YBR096W,2,436015,436707,692,+,Uncharacterized
VPS15,YBR097W,2,436945,441309,4364,+,Verified
MMS4,YBR098W,2,441509,443584,2075,+,Verified
YBR099C,YBR099C,2,442918,443301,383,-,Dubious
FES1,YBR101C,2,443815,444687,872,-,Verified
EXO84,YBR102C,2,445056,447317,2261,-,Verified
SIF2,YBR103W,2,447703,449310,1607,+,Verified
YBR103C-A,YBR103C-A,2,449314,449457,143,-,Dubious
YMC2,YBR104W,2,449661,450650,989,+,Verified
VID24,YBR105C,2,450875,451963,1088,-,Verified
PHO88,YBR106W,2,452652,453218,566,+,Verified
IML3,YBR107C,2,453787,454524,737,-,Verified
AIM3,YBR108W,2,454816,457659,2843,+,Uncharacterized
CMD1,YBR109C,2,457913,458356,443,-,Verified
YBR109W-A,YBR109W-A,2,458602,458826,224,+,Dubious
ALG1,YBR110W,2,458866,460215,1349,+,Verified
YSA1,YBR111C,2,461172,461867,695,-,Verified
SUS1,YBR111W-A,2,462133,462573,440,+,Verified
CYC8,YBR112C,2,462864,465764,2900,-,Verified
YBR113W,YBR113W,2,465560,466042,482,+,Dubious
RAD16,YBR114W,2,467242,469614,2372,+,Verified
LYS2,YBR115C,2,469742,473920,4178,-,Verified
YBR116C,YBR116C,2,474193,474720,527,-,Dubious
TKL2,YBR117C,2,474386,476431,2045,-,Verified
TEF2,YBR118W,2,477665,479041,1376,+,Verified
MUD1,YBR119W,2,479332,480317,985,+,Verified
CBP6,YBR120C,2,480429,480917,488,-,Verified
GRS1,YBR121C,2,481358,483361,2003,-,Verified
YBR121C-A,YBR121C-A,2,482320,482478,158,-,Dubious
MRPL36,YBR122C,2,483964,484497,533,-,Verified
TFC1,YBR123C,2,484736,486685,1949,-,Verified
YBR124W,YBR124W,2,486501,486860,359,+,Dubious
PTC4,YBR125C,2,487193,488374,1181,-,Verified
TPS1,YBR126C,2,488899,490386,1487,-,Verified
YBR126W-A,YBR126W-A,2,490844,491050,206,+,Dubious
YBR126W-B,YBR126W-B,2,490921,491064,143,+,Dubious
VMA2,YBR127C,2,491263,492816,1553,-,Verified
ATG14,YBR128C,2,493075,494109,1034,-,Verified
OPY1,YBR129C,2,494347,495333,986,-,Verified
SHE3,YBR130C,2,495586,496863,1277,-,Verified
CCZ1,YBR131W,2,497157,499271,2114,+,Verified
YBR131C-A,YBR131C-A,2,497644,497733,89,-,Dubious
AGP2,YBR132C,2,499646,501436,1790,-,Verified
HSL7,YBR133C,2,501798,504281,2483,-,Verified
YBR134W,YBR134W,2,504237,504638,401,+,Dubious
CKS1,YBR135W,2,504848,505300,452,+,Verified
MEC1,YBR136W,2,505662,512768,7106,+,Verified
YBR137W,YBR137W,2,513038,513577,539,+,Uncharacterized
YBR138C,YBR138C,2,513756,515330,1574,-,Uncharacterized
YBR139W,YBR139W,2,515658,517184,1526,+,Verified
IRA1,YBR140C,2,517344,526622,9278,-,Verified
YBR141C,YBR141C,2,527019,528032,1013,-,Uncharacterized
YBR141W-A,YBR141W-A,2,527161,527256,95,+,Dubious
MAK5,YBR142W,2,528311,530632,2321,+,Verified
SUP45,YBR143C,2,530863,532176,1313,-,Verified
YBR144C,YBR144C,2,533229,533543,314,-,Dubious
ADH5,YBR145W,2,533756,534811,1055,+,Verified
MRPS9,YBR146W,2,535254,536090,836,+,Verified
RTC2,YBR147W,2,536569,537459,890,+,Uncharacterized
YSW1,YBR148W,2,537870,539699,1829,+,Verified
ARA1,YBR149W,2,539981,541015,1034,+,Verified
TBS1,YBR150C,2,541203,544487,3284,-,Verified
APD1,YBR151W,2,545022,545972,950,+,Verified
SPP381,YBR152W,2,546370,547245,875,+,Verified
RIB7,YBR153W,2,547454,548188,734,+,Verified
RPB5,YBR154C,2,548356,549003,647,-,Verified
CNS1,YBR155W,2,549765,550922,1157,+,Verified
SLI15,YBR156C,2,551098,553194,2096,-,Verified
ICS2,YBR157C,2,553537,554304,767,-,Verified
AMN1,YBR158W,2,556543,558192,1649,+,Verified
IFA38,YBR159W,2,558679,559722,1043,+,Verified
CDC28,YBR160W,2,560072,560968,896,+,Verified
CSH1,YBR161W,2,561629,562759,1130,+,Verified
TOS1,YBR162C,2,563198,564565,1367,-,Verified
YSY6,YBR162W-A,2,565226,565423,197,+,Verified
DEM1,YBR163W,2,565718,567475,1757,+,Verified
ARL1,YBR164C,2,567870,568421,551,-,Verified
UBS1,YBR165W,2,568847,569680,833,+,Verified
TYR1,YBR166C,2,569837,571195,1358,-,Verified
POP7,YBR167C,2,571463,571885,422,-,Verified
PEX32,YBR168W,2,572366,573607,1241,+,Verified
SSE2,YBR169C,2,573910,575991,2081,-,Verified
NPL4,YBR170C,2,576339,578081,1742,-,Verified
SEC66,YBR171W,2,578359,578979,620,+,Verified
SMY2,YBR172C,2,579145,581367,2222,-,Verified
UMP1,YBR173C,2,581721,582167,446,-,Verified
YBR174C,YBR174C,2,582333,582647,314,-,Dubious
SWD3,YBR175W,2,582403,583350,947,+,Verified
ECM31,YBR176W,2,583715,584653,938,+,Verified
EHT1,YBR177C,2,584802,586157,1355,-,Verified
YBR178W,YBR178W,2,586066,586440,374,+,Dubious
FZO1,YBR179C,2,586542,589109,2567,-,Verified
DTR1,YBR180W,2,589736,591454,1718,+,Verified
RPS6B,YBR181C,2,591707,592769,1062,-,Verified
SMP1,YBR182C,2,593501,594859,1358,-,Verified
YBR182C-A,YBR182C-A,2,595356,595550,194,-,Uncharacterized
YPC1,YBR183W,2,596110,597060,950,+,Verified
YBR184W,YBR184W,2,597358,598929,1571,+,Uncharacterized
MBA1,YBR185C,2,599118,599954,836,-,Verified
PCH2,YBR186W,2,600548,602355,1807,+,Verified
GDT1,YBR187W,2,602629,603471,842,+,Uncharacterized
NTC20,YBR188C,2,603680,604102,422,-,Verified
RPS9B,YBR189W,2,604503,605503,1000,+,Verified
YBR190W,YBR190W,2,605961,606272,311,+,Dubious
RPL21A,YBR191W,2,606265,607135,870,+,Verified
YBR191W-A,YBR191W-A,2,607144,607218,74,+,Dubious
RIM2,YBR192W,2,607647,608780,1133,+,Verified
MED8,YBR193C,2,609077,609748,671,-,Verified
AIM4,YBR194W,2,610033,610404,371,+,Uncharacterized
MSI1,YBR195C,2,610609,611877,1268,-,Verified
PGI1,YBR196C,2,612231,613895,1664,-,Verified
YBR196C-A,YBR196C-A,2,614019,614168,149,-,Uncharacterized
YBR196C-B,YBR196C-B,2,614521,614625,104,-,Uncharacterized
YBR197C,YBR197C,2,615198,615851,653,-,Uncharacterized
TAF5,YBR198C,2,616122,618518,2396,-,Verified
KTR4,YBR199W,2,618904,620298,1394,+,Verified
BEM1,YBR200W,2,620867,622522,1655,+,Verified
YBR200W-A,YBR200W-A,2,622978,623142,164,+,Uncharacterized
DER1,YBR201W,2,623572,624207,635,+,Verified
YBR201C-A,YBR201C-A,2,624489,624692,203,-,Uncharacterized
MCM7,YBR202W,2,625767,628304,2537,+,Verified
COS111,YBR203W,2,629163,631937,2774,+,Verified
YBR204C,YBR204C,2,632249,633376,1127,-,Uncharacterized
KTR3,YBR205W,2,633617,634831,1214,+,Verified
YBR206W,YBR206W,2,634596,634919,323,+,Dubious
FTH1,YBR207W,2,635141,636538,1397,+,Verified
DUR1%2C2,YBR208C,2,636698,642205,5507,-,Verified
YBR209W,YBR209W,2,642578,642895,317,+,Dubious
ERV15,YBR210W,2,645545,645973,428,+,Verified
AME1,YBR211C,2,646153,647127,974,-,Verified
NGR1,YBR212W,2,647881,649899,2018,+,Verified
MET8,YBR213W,2,650363,651187,824,+,Verified
SDS24,YBR214W,2,651410,652993,1583,+,Verified
HPC2,YBR215W,2,653351,655312,1961,+,Verified
YBP1,YBR216C,2,655571,657595,2024,-,Verified
ATG12,YBR217W,2,657827,658387,560,+,Verified
PYC2,YBR218C,2,658702,662244,3542,-,Verified
YBR219C,YBR219C,2,662494,663298,804,-,Uncharacterized
YBR220C,YBR220C,2,662990,664672,1682,-,Uncharacterized
PDB1,YBR221C,2,665148,666248,1100,-,Verified
YBR221W-A,YBR221W-A,2,666533,666637,104,+,Uncharacterized
PCS60,YBR222C,2,666715,668346,1631,-,Verified
TDP1,YBR223C,2,668658,670292,1634,-,Verified
YBR223W-A,YBR223W-A,2,668716,668835,119,+,Dubious
YBR224W,YBR224W,2,670120,670635,515,+,Dubious
YBR225W,YBR225W,2,670622,673324,2702,+,Uncharacterized
YBR226C,YBR226C,2,673150,673560,410,-,Dubious
MCX1,YBR227C,2,673567,675129,1562,-,Verified
SLX1,YBR228W,2,675308,676222,914,+,Verified
ROT2,YBR229C,2,676352,679216,2864,-,Verified
OM14,YBR230C,2,679544,680045,501,-,Verified
YBR230W-A,YBR230W-A,2,680357,680557,200,+,Uncharacterized
SWC5,YBR231C,2,682174,683085,911,-,Verified
YBR232C,YBR232C,2,683368,683727,359,-,Dubious
PBP2,YBR233W,2,683423,684664,1241,+,Verified
DAD3,YBR233W-A,2,684972,685256,284,+,Verified
ARC40,YBR234C,2,685433,686587,1154,-,Verified
YBR235W,YBR235W,2,686896,690258,3362,+,Uncharacterized
ABD1,YBR236C,2,690378,691688,1310,-,Verified
PRP5,YBR237W,2,691964,694513,2549,+,Verified
YBR238C,YBR238C,2,695102,697297,2195,-,Verified
ERT1,YBR239C,2,698349,699938,1589,-,Uncharacterized
THI2,YBR240C,2,700485,701837,1352,-,Verified
YBR241C,YBR241C,2,702584,704050,1466,-,Uncharacterized
YBR242W,YBR242W,2,704665,705381,716,+,Uncharacterized
ALG7,YBR243C,2,705442,706788,1346,-,Verified
GPX2,YBR244W,2,707523,708011,488,+,Verified
ISW1,YBR245C,2,708145,711534,3389,-,Verified
YBR246W,YBR246W,2,711586,712749,1163,+,Uncharacterized
ENP1,YBR247C,2,712999,714450,1451,-,Verified
HIS7,YBR248C,2,714802,716460,1658,-,Verified
ARO4,YBR249C,2,716877,717989,1112,-,Verified
SPO23,YBR250W,2,719028,720599,1571,+,Verified
MRPS5,YBR251W,2,721385,722308,923,+,Verified
DUT1,YBR252W,2,722606,723049,443,+,Verified
SRB6,YBR253W,2,723265,723630,365,+,Verified
TRS20,YBR254C,2,723731,724258,527,-,Verified
MTC4,YBR255W,2,724451,726535,2084,+,Uncharacterized
YBR255C-A,YBR255C-A,2,726613,727069,456,-,Uncharacterized
RIB5,YBR256C,2,727381,728097,716,-,Verified
POP4,YBR257W,2,728880,729719,839,+,Verified
SHG1,YBR258C,2,729729,730157,428,-,Verified
YBR259W,YBR259W,2,730382,732448,2066,+,Uncharacterized
RGD1,YBR260C,2,732634,734634,2000,-,Verified
YBR261C,YBR261C,2,734827,735525,698,-,Uncharacterized
AIM5,YBR262C,2,735715,736035,320,-,Uncharacterized
SHM1,YBR263W,2,736259,737731,1472,+,Verified
YPT10,YBR264C,2,737765,738364,599,-,Verified
TSC10,YBR265W,2,738577,739539,962,+,Verified
REI1,YBR267W,2,739836,741017,1181,+,Verified
SLM6,YBR266C,2,739931,740383,452,-,Dubious
MRPL37,YBR268W,2,741294,741611,317,+,Verified
FMP21,YBR269C,2,742155,742571,416,-,Uncharacterized
BIT2,YBR270C,2,742756,744393,1637,-,Uncharacterized
YBR271W,YBR271W,2,744847,746106,1259,+,Uncharacterized
HSM3,YBR272C,2,746356,747798,1442,-,Verified
UBX7,YBR273C,2,748056,749366,1310,-,Verified
CHK1,YBR274W,2,749589,751172,1583,+,Verified
RIF1,YBR275C,2,751351,757101,5750,-,Verified
PPS1,YBR276C,2,757616,760039,2423,-,Verified
YBR277C,YBR277C,2,760211,760612,401,-,Dubious
DPB3,YBR278W,2,760290,760895,605,+,Verified
PAF1,YBR279W,2,761253,762590,1337,+,Verified
SAF1,YBR280C,2,762780,764693,1913,-,Verified
DUG2,YBR281C,2,764966,767602,2636,-,Verified
MRPL27,YBR282W,2,768236,768676,440,+,Verified
SSH1,YBR283C,2,768939,770411,1472,-,Verified
YBR284W,YBR284W,2,771235,773628,2393,+,Uncharacterized
YBR285W,YBR285W,2,773918,774352,434,+,Uncharacterized
APE3,YBR286W,2,774696,776309,1613,+,Verified
YBR287W,YBR287W,2,776567,777850,1283,+,Uncharacterized
APM3,YBR288C,2,778008,779459,1451,-,Verified
SNF5,YBR289W,2,779663,782380,2717,+,Verified
BSD2,YBR290W,2,782587,783552,965,+,Verified
CTP1,YBR291C,2,783669,784568,899,-,Verified
YBR292C,YBR292C,2,784698,785069,371,-,Dubious
VBA2,YBR293W,2,787001,788425,1424,+,Verified
SUL1,YBR294W,2,789230,791809,2579,+,Verified
PCA1,YBR295W,2,792843,796493,3650,+,Verified
PHO89,YBR296C,2,796792,798516,1724,-,Verified
YBR296C-A,YBR296C-A,2,800117,800236,119,-,Uncharacterized
MAL33,YBR297W,2,800517,801923,1406,+,Verified
MAL31,YBR298C,2,802625,804469,1844,-,Verified
YBR298C-A,YBR298C-A,2,805029,805250,221,-,Uncharacterized
MAL32,YBR299W,2,805345,807099,1754,+,Verified
YBR300C,YBR300C,2,808594,809091,497,-,Dubious
DAN3,YBR301W,2,809051,809413,362,+,Verified
COS2,YBR302C,2,810334,811473,1139,-,Verified
YCL076W,YCL076W,3,1392,2135,743,+,Dubious
YCL073C,YCL073C,3,6479,8326,1847,-,Uncharacterized
VBA3,YCL069W,3,9706,11082,1376,+,Verified
YCL068C,YCL068C,3,11503,12285,782,-,Uncharacterized
HMLALPHA2,YCL067C,3,12386,13018,632,-,Verified
HMLALPHA1,YCL066W,3,13282,13809,527,+,Verified
YCL065W,YCL065W,3,13751,14119,368,+,Dubious
CHA1,YCL064C,3,15798,16880,1082,-,Verified
VAC17,YCL063W,3,17290,18561,1271,+,Verified
MRC1,YCL061C,3,18816,22106,3290,-,Verified
KRR1,YCL059C,3,22429,23379,950,-,Verified
FYV5,YCL058C,3,23523,23981,458,-,Dubious
YCL058W-A,YCL058W-A,3,23584,23925,341,+,Uncharacterized
YCL057C-A,YCL057C-A,3,24032,24325,293,-,Uncharacterized
PRD1,YCL057W,3,24768,26906,2138,+,Verified
YCL056C,YCL056C,3,26925,27359,434,-,Uncharacterized
KAR4,YCL055W,3,27929,28936,1007,+,Verified
SPB1,YCL054W,3,31449,33974,2525,+,Verified
PBN1,YCL052C,3,34143,35393,1250,-,Verified
LRE1,YCL051W,3,35865,37616,1751,+,Verified
APA1,YCL050C,3,37836,38801,965,-,Verified
YCL049C,YCL049C,3,39786,40724,938,-,Uncharacterized
YCL048W-A,YCL048W-A,3,41488,41727,239,+,Uncharacterized
SPS22,YCL048W,3,42165,43556,1391,+,Verified
YCL047C,YCL047C,3,43661,44437,776,-,Uncharacterized
YCL045C,YCL045C,3,44623,46905,2282,-,Uncharacterized
YCL046W,YCL046W,3,46640,46963,323,+,Dubious
MGR1,YCL044C,3,47111,48364,1253,-,Verified
PDI1,YCL043C,3,48653,50221,1568,-,Verified
YCL041C,YCL041C,3,50133,50627,494,-,Dubious
YCL042W,YCL042W,3,50584,50943,359,+,Uncharacterized
GLK1,YCL040W,3,50838,52340,1502,+,Verified
GID7,YCL039W,3,52645,54882,2237,+,Verified
ATG22,YCL038C,3,54941,56527,1586,-,Verified
SRO9,YCL037C,3,57374,58678,1304,-,Verified
GFD2,YCL036W,3,59026,60726,1700,+,Verified
GRX1,YCL035C,3,60841,61173,332,-,Verified
LSB5,YCL034W,3,61658,62722,1064,+,Verified
YCL033C,YCL033C,3,62776,63282,506,-,Uncharacterized
STE50,YCL032W,3,63441,64481,1040,+,Verified
RRP7,YCL031C,3,64675,65568,893,-,Verified
HIS4,YCL030C,3,65934,68333,2399,-,Verified
BIK1,YCL029C,3,68599,69921,1322,-,Verified
RNQ1,YCL028W,3,70150,71367,1217,+,Verified
FUS1,YCL027W,3,71803,73341,1538,+,Verified
HBN1,YCL026C-B,3,73405,73986,581,-,Uncharacterized
FRM2,YCL026C-A,3,74704,75285,581,-,Verified
AGP1,YCL025C,3,76018,77919,1901,-,Verified
YCL023C,YCL023C,3,78949,79296,347,-,Dubious
KCC4,YCL024W,3,79162,82275,3113,+,Verified
YCL022C,YCL022C,3,81570,82085,515,-,Dubious
YCL021W-A,YCL021W-A,3,83620,83997,377,+,Uncharacterized
LEU2,YCL018W,3,91324,92418,1094,+,Verified
NFS1,YCL017C,3,92777,94270,1493,-,Verified
DCC1,YCL016C,3,94621,95763,1142,-,Verified
BUD3,YCL014W,3,96281,101191,4910,+,Verified
YCL012C,YCL012C,3,101317,101788,471,-,Verified
GBP2,YCL011C,3,102075,103358,1283,-,Verified
SGF29,YCL010C,3,103571,104350,779,-,Verified
ILV6,YCL009C,3,104619,105548,929,-,Verified
STP22,YCL008C,3,105696,106853,1157,-,Verified
YCL007C,YCL007C,3,106974,107366,392,-,Dubious
VMA9,YCL005W-A,3,107023,107417,394,+,Verified
LDB16,YCL005W,3,108021,108791,770,+,Verified
PGS1,YCL004W,3,109105,110670,1565,+,Verified
YCL002C,YCL002C,3,110843,111674,831,-,Uncharacterized
RER1,YCL001W,3,111914,112480,566,+,Verified
YCL001W-A,YCL001W-A,3,113078,113539,461,+,Uncharacterized
YCL001W-B,YCL001W-B,3,113768,114022,254,+,Uncharacterized
YCR001W,YCR001W,3,115683,115997,314,+,Dubious
CDC10,YCR002C,3,117378,118346,968,-,Verified
MRPL32,YCR003W,3,118618,119169,551,+,Verified
YCP4,YCR004C,3,119573,120316,743,-,Verified
CIT2,YCR005C,3,120944,122326,1382,-,Verified
YCR006C,YCR006C,3,122528,123001,473,-,Dubious
YCR007C,YCR007C,3,126009,126728,719,-,Uncharacterized
SAT4,YCR008W,3,128468,130279,1811,+,Verified
RVS161,YCR009C,3,130743,131540,797,-,Verified
ADY2,YCR010C,3,132271,133122,851,-,Verified
ADP1,YCR011C,3,133722,136871,3149,-,Verified
PGK1,YCR012W,3,137744,138994,1250,+,Verified
YCR013C,YCR013C,3,138400,139047,647,-,Dubious
POL4,YCR014C,3,139183,140931,1748,-,Verified
YCR015C,YCR015C,3,141215,142168,953,-,Uncharacterized
YCR016W,YCR016W,3,143632,144504,872,+,Uncharacterized
CWH43,YCR017C,3,144771,147632,2861,-,Verified
SRD1,YCR018C,3,148236,148901,665,-,Verified
YCR018C-A,YCR018C-A,3,151606,151860,254,-,Dubious
MAK32,YCR019W,3,152835,153926,1091,+,Verified
PET18,YCR020C,3,154010,154657,647,-,Verified
MAK31,YCR020C-A,3,154828,155094,266,-,Verified
HTL1,YCR020W-B,3,155318,155554,236,+,Verified
HSP30,YCR021C,3,156105,157103,998,-,Verified
YCR022C,YCR022C,3,157417,157761,344,-,Dubious
YCR023C,YCR023C,3,158534,160369,1835,-,Verified
SLM5,YCR024C,3,160740,162218,1478,-,Verified
YCR024C-B,YCR024C-B,3,162595,162861,266,-,Uncharacterized
PMP1,YCR024C-A,3,162941,163063,122,-,Verified
YCR025C,YCR025C,3,163442,163852,410,-,Dubious
NPP1,YCR026C,3,164107,166335,2228,-,Verified
RHB1,YCR027C,3,167366,167995,629,-,Verified
FEN2,YCR028C,3,170882,172420,1538,-,Verified
RIM1,YCR028C-A,3,172946,173436,490,-,Verified
SYP1,YCR030C,3,173822,176434,2612,-,Verified
RPS14A,YCR031C,3,177496,178216,720,-,Verified
BPH1,YCR032W,3,179516,186019,6503,+,Verified
SNT1,YCR033W,3,186485,190165,3680,+,Verified
FEN1,YCR034W,3,190588,191631,1043,+,Verified
RRP43,YCR035C,3,191830,193014,1184,-,Verified
RBK1,YCR036W,3,193293,194294,1001,+,Verified
PHO87,YCR037C,3,194410,197181,2771,-,Verified
BUD5,YCR038C,3,197617,199545,1928,-,Verified
YCR038W-A,YCR038W-A,3,199289,199414,125,+,Dubious
MATALPHA2,YCR039C,3,199542,200174,632,-,Verified
MATALPHA1,YCR040W,3,200438,200965,527,+,Verified
YCR041W,YCR041W,3,200907,201239,332,+,Dubious
TAF2,YCR042C,3,201170,205393,4223,-,Verified
YCR043C,YCR043C,3,206257,206640,383,-,Uncharacterized
PER1,YCR044C,3,206873,207946,1073,-,Verified
YCR045C,YCR045C,3,208131,209606,1475,-,Uncharacterized
YCR045W-A,YCR045W-A,3,208747,209097,350,+,Dubious
IMG1,YCR046C,3,209910,210419,509,-,Verified
BUD23,YCR047C,3,210714,211541,827,-,Verified
YCR047W-A,YCR047W-A,3,211297,211503,206,+,Dubious
YCR049C,YCR049C,3,211867,212313,446,-,Dubious
ARE1,YCR048W,3,211925,213757,1832,+,Verified
YCR050C,YCR050C,3,213460,213768,308,-,Uncharacterized
YCR051W,YCR051W,3,214067,214735,668,+,Uncharacterized
RSC6,YCR052W,3,214990,216441,1451,+,Verified
THR4,YCR053W,3,216693,218237,1544,+,Verified
CTR86,YCR054C,3,218372,220063,1691,-,Verified
PWP2,YCR057C,3,220453,223224,2771,-,Verified
YIH1,YCR059C,3,223450,224226,776,-,Verified
TAH1,YCR060W,3,224395,224730,335,+,Verified
YCR061W,YCR061W,3,225559,227454,1895,+,Uncharacterized
YCR064C,YCR064C,3,228091,228501,410,-,Dubious
BUD31,YCR063W,3,228314,228787,473,+,Verified
HCM1,YCR065W,3,229306,231000,1694,+,Verified
RAD18,YCR066W,3,231496,232959,1463,+,Verified
SED4,YCR067C,3,233121,236318,3197,-,Verified
ATG15,YCR068W,3,237210,238772,1562,+,Verified
CPR4,YCR069W,3,239051,240007,956,+,Verified
IMG2,YCR071C,3,240099,240539,440,-,Verified
RSA4,YCR072C,3,240801,242348,1547,-,Verified
SSK22,YCR073C,3,242585,246580,3995,-,Verified
SOL2,YCR073W-A,3,246960,247907,947,+,Verified
ERS1,YCR075C,3,248030,248812,782,-,Verified
YCR075W-A,YCR075W-A,3,248972,249199,227,+,Uncharacterized
YCR076C,YCR076C,3,249290,250042,752,-,Uncharacterized
PAT1,YCR077C,3,250235,252625,2390,-,Verified
PTC6,YCR079W,3,252842,254170,1328,+,Verified
SRB8,YCR081W,3,254368,258651,4283,+,Verified
YCR081C-A,YCR081C-A,3,258412,258648,236,-,Dubious
AHC2,YCR082W,3,258880,259266,386,+,Verified
TRX3,YCR083W,3,259575,259958,383,+,Verified
TUP1,YCR084C,3,260308,262449,2141,-,Verified
YCR085W,YCR085W,3,262913,263266,353,+,Dubious
CSM1,YCR086W,3,263389,263961,572,+,Verified
YCR087W,YCR087W,3,263973,264488,515,+,Dubious
LUG1,YCR087C-A,3,264003,264464,461,-,Uncharacterized
ABP1,YCR088W,3,265065,266843,1778,+,Verified
FIG2,YCR089W,3,267431,272260,4829,+,Verified
YCR090C,YCR090C,3,272312,272860,548,-,Uncharacterized
KIN82,YCR091W,3,274401,276563,2162,+,Verified
MSH3,YCR092C,3,276761,279817,3056,-,Verified
CDC39,YCR093W,3,280114,286440,6326,+,Verified
CDC50,YCR094W,3,286759,287934,1175,+,Verified
OCA4,YCR095C,3,288167,289255,1088,-,Uncharacterized
YCR095W-A,YCR095W-A,3,289636,289794,158,+,Uncharacterized
HMRA2,YCR096C,3,293176,293535,359,-,Verified
HMRA1,YCR097W,3,293832,294318,486,+,Verified
YCR097W-A,YCR097W-A,3,294436,294702,266,+,Dubious
GIT1,YCR098C,3,297046,298602,1556,-,Verified
YCR099C,YCR099C,3,300829,301296,467,-,Uncharacterized
YCR100C,YCR100C,3,301268,302218,950,-,Uncharacterized
YCR101C,YCR101C,3,302479,303027,548,-,Uncharacterized
YCR102C,YCR102C,3,304358,305464,1106,-,Uncharacterized
YCR102W-A,YCR102W-A,3,306732,306929,197,+,Dubious
PAU3,YCR104W,3,307798,308172,374,+,Verified
ADH7,YCR105W,3,309067,310152,1085,+,Verified
RDS1,YCR106W,3,310955,313453,2498,+,Verified
AAD3,YCR107W,3,313887,314978,1091,+,Verified
YCR108C,YCR108C,3,315994,316185,191,-,Uncharacterized
COS7,YDL248W,4,1802,2953,1151,+,Verified
YDL247W-A,YDL247W-A,4,3762,3836,74,+,Dubious
MPH2,YDL247W,4,5985,7814,1829,+,Verified
SOR2,YDL246C,4,8683,9756,1073,-,Uncharacterized
HXT15,YDL245C,4,11657,13360,1703,-,Verified
THI13,YDL244W,4,16204,17226,1022,+,Verified
AAD4,YDL243C,4,17577,18566,989,-,Verified
YDL242W,YDL242W,4,18959,19312,353,+,Dubious
YDL241W,YDL241W,4,20635,21006,371,+,Uncharacterized
YDL240C-A,YDL240C-A,4,22471,22608,137,-,Dubious
LRG1,YDL240W,4,22823,25876,3053,+,Verified
ADY3,YDL239C,4,26403,28775,2372,-,Verified
GUD1,YDL238C,4,28985,30454,1469,-,Verified
LRC1,YDL237W,4,30657,31829,1172,+,Uncharacterized
PHO13,YDL236W,4,32296,33234,938,+,Verified
YPD1,YDL235C,4,33415,33918,503,-,Verified
GYP7,YDL234C,4,34238,36478,2240,-,Verified
YDL233W,YDL233W,4,36798,38174,1376,+,Uncharacterized
OST4,YDL232W,4,38488,38598,110,+,Verified
BRE4,YDL231C,4,38868,42245,3377,-,Verified
PTP1,YDL230W,4,42701,43708,1007,+,Verified
SSB1,YDL229W,4,44066,45907,1841,+,Verified
YDL228C,YDL228C,4,45278,45919,641,-,Dubious
HO,YDL227C,4,46272,48032,1760,-,Verified
GCS1,YDL226C,4,51116,52174,1058,-,Verified
SHS1,YDL225W,4,52446,54101,1655,+,Verified
WHI4,YDL224C,4,54398,56347,1949,-,Verified
HBT1,YDL223C,4,57266,60406,3140,-,Verified
FMP45,YDL222C,4,60873,61802,929,-,Verified
YDL221W,YDL221W,4,62012,62563,551,+,Dubious
CDC13,YDL220C,4,62245,65019,2774,-,Verified
DTD1,YDL219W,4,65243,65766,523,+,Verified
YDL218W,YDL218W,4,66494,67447,953,+,Uncharacterized
TIM22,YDL217C,4,67984,68607,623,-,Verified
RRI1,YDL216C,4,68998,70320,1322,-,Verified
GDH2,YDL215C,4,70641,73919,3278,-,Verified
PRR2,YDL214C,4,74447,76546,2099,-,Verified
NOP6,YDL213C,4,77290,77967,677,-,Verified
SHR3,YDL212W,4,78427,79059,632,+,Verified
YDL211C,YDL211C,4,79295,80413,1118,-,Uncharacterized
UGA4,YDL210W,4,84271,85986,1715,+,Verified
CWC2,YDL209C,4,86208,87227,1019,-,Verified
NHP2,YDL208W,4,87513,87983,470,+,Verified
GLE1,YDL207W,4,88249,89865,1616,+,Verified
YDL206W,YDL206W,4,90177,92465,2288,+,Uncharacterized
HEM3,YDL205C,4,92763,93746,983,-,Verified
RTN2,YDL204W,4,94606,95787,1181,+,Verified
ACK1,YDL203C,4,96083,97954,1871,-,Uncharacterized
MRPL11,YDL202W,4,98476,99225,749,+,Verified
TRM8,YDL201W,4,99562,100422,860,+,Verified
MGT1,YDL200C,4,100502,101068,566,-,Verified
YDL199C,YDL199C,4,101291,103354,2063,-,Uncharacterized
GGC1,YDL198C,4,103650,104552,902,-,Verified
ASF2,YDL197C,4,104918,106495,1577,-,Verified
YDL196W,YDL196W,4,106742,107071,329,+,Dubious
SEC31,YDL195W,4,107209,111030,3821,+,Verified
SNF3,YDL194W,4,111581,114235,2654,+,Verified
NUS1,YDL193W,4,114673,115800,1127,+,Verified
ARF1,YDL192W,4,116322,116867,545,+,Verified
RPL35A,YDL191W,4,117665,118518,853,+,Verified
UFD2,YDL190C,4,118708,121593,2885,-,Verified
RBS1,YDL189W,4,122079,123590,1511,+,Verified
PPH22,YDL188C,4,123866,124999,1133,-,Verified
YDL187C,YDL187C,4,125510,125839,329,-,Dubious
YDL186W,YDL186W,4,125617,126450,833,+,Uncharacterized
YDL185C-A,YDL185C-A,4,126609,126836,227,-,Dubious
TFP1,YDL185W,4,126788,130003,3215,+,Verified
RPL41A,YDL184C,4,130408,130485,77,-,Verified
YDL183C,YDL183C,4,130872,131834,962,-,Uncharacterized
LYS20,YDL182W,4,133438,134724,1286,+,Verified
INH1,YDL181W,4,135180,135437,257,+,Verified
YDL180W,YDL180W,4,135897,137540,1643,+,Uncharacterized
PCL9,YDL179W,4,138292,139206,914,+,Verified
DLD2,YDL178W,4,139523,141115,1592,+,Verified
YDL177C,YDL177C,4,141210,141722,512,-,Uncharacterized
YDL176W,YDL176W,4,142098,144224,2126,+,Uncharacterized
AIR2,YDL175C,4,144485,145519,1034,-,Verified
DLD1,YDL174C,4,145827,147590,1763,-,Verified
YDL173W,YDL173W,4,148192,149079,887,+,Uncharacterized
YDL172C,YDL172C,4,148608,149087,479,-,Dubious
GLT1,YDL171C,4,149204,155641,6437,-,Verified
UGA3,YDL170W,4,156319,157905,1586,+,Verified
UGX2,YDL169C,4,158065,158736,671,-,Verified
SFA1,YDL168W,4,159605,160765,1160,+,Verified
NRP1,YDL167C,4,160996,163155,2159,-,Verified
FAP7,YDL166C,4,163450,164043,593,-,Verified
CDC36,YDL165W,4,164291,164866,575,+,Verified
CDC9,YDL164C,4,164988,167255,2267,-,Verified
YDL163W,YDL163W,4,166957,167259,302,+,Dubious
YDL162C,YDL162C,4,167360,167716,356,-,Dubious
ENT1,YDL161W,4,167715,169079,1364,+,Verified
YDL160C-A,YDL160C-A,4,169367,169609,242,-,Uncharacterized
DHH1,YDL160C,4,170411,171931,1520,-,Verified
YDL159W-A,YDL159W-A,4,172183,172314,131,+,Uncharacterized
STE7,YDL159W,4,172482,174029,1547,+,Verified
YDL159C-B,YDL159C-B,4,173057,173233,176,-,Dubious
YDL158C,YDL158C,4,173867,174175,308,-,Dubious
YDL157C,YDL157C,4,174233,174589,356,-,Uncharacterized
YDL156W,YDL156W,4,174919,176487,1568,+,Uncharacterized
CLB3,YDL155W,4,176774,178057,1283,+,Verified
MSH5,YDL154W,4,178335,181040,2705,+,Verified
SAS10,YDL153C,4,181187,183019,1832,-,Verified
YDL152W,YDL152W,4,182823,183188,365,+,Dubious
BUD30,YDL151C,4,183319,183900,581,-,Dubious
RPC53,YDL150W,4,183344,184612,1268,+,Verified
ATG9,YDL149W,4,184926,187919,2993,+,Verified
NOP14,YDL148C,4,188155,190587,2432,-,Verified
RPN5,YDL147W,4,190925,192262,1337,+,Verified
LDB17,YDL146W,4,192751,194226,1475,+,Verified
COP1,YDL145C,4,194572,198177,3605,-,Verified
YDL144C,YDL144C,4,198663,199733,1070,-,Uncharacterized
CCT4,YDL143W,4,199997,201583,1586,+,Verified
CRD1,YDL142C,4,201720,202571,851,-,Verified
BPL1,YDL141W,4,203040,205112,2072,+,Verified
RPO21,YDL140C,4,205361,210562,5201,-,Verified
SCM3,YDL139C,4,211376,212047,671,-,Verified
RGT2,YDL138W,4,213352,215643,2291,+,Verified
ARF2,YDL137W,4,216158,217074,916,+,Verified
RPL35B,YDL136W,4,217600,218367,767,+,Verified
RDI1,YDL135C,4,218680,219288,608,-,Verified
PPH21,YDL134C,4,219662,220771,1109,-,Verified
RPL41B,YDL133C-A,4,221724,221801,77,-,Verified
YDL133W,YDL133W,4,222427,223740,1313,+,Uncharacterized
CDC53,YDL132W,4,224304,226751,2447,+,Verified
LYS21,YDL131W,4,227393,228715,1322,+,Verified
STF1,YDL130W-A,4,229171,229431,260,+,Verified
RPP1B,YDL130W,4,229906,230527,621,+,Verified
YDL129W,YDL129W,4,231024,231899,875,+,Uncharacterized
VCX1,YDL128W,4,232652,233887,1235,+,Verified
PCL2,YDL127W,4,234927,235853,926,+,Verified
CDC48,YDL126C,4,236157,238664,2507,-,Verified
HNT1,YDL125C,4,239019,239606,587,-,Verified
YDL124W,YDL124W,4,240259,241197,938,+,Verified
SNA4,YDL123W,4,241418,241840,422,+,Verified
UBP1,YDL122W,4,242552,244981,2429,+,Verified
YDL121C,YDL121C,4,245133,245582,449,-,Uncharacterized
YFH1,YDL120W,4,245923,246447,524,+,Verified
YDL119C,YDL119C,4,246689,247612,923,-,Uncharacterized
YDL118W,YDL118W,4,247302,247682,380,+,Uncharacterized
CYK3,YDL117W,4,248581,251238,2657,+,Verified
NUP84,YDL116W,4,251566,253746,2180,+,Verified
IWR1,YDL115C,4,253995,255126,1131,-,Verified
YDL114W-A,YDL114W-A,4,254935,255048,113,+,Dubious
YDL114W,YDL114W,4,255604,256530,926,+,Uncharacterized
ATG20,YDL113C,4,256633,258555,1922,-,Verified
TRM3,YDL112W,4,258915,263225,4310,+,Verified
RRP42,YDL111C,4,263313,264110,797,-,Verified
TMA17,YDL110C,4,264512,264964,452,-,Verified
YDL109C,YDL109C,4,265258,267201,1943,-,Uncharacterized
KIN28,YDL108W,4,267698,268699,1001,+,Verified
MSS2,YDL107W,4,268921,269976,1055,+,Verified
PHO2,YDL106C,4,270222,271901,1679,-,Verified
NSE4,YDL105W,4,272389,273597,1208,+,Verified
QRI7,YDL104C,4,273653,274876,1223,-,Uncharacterized
QRI1,YDL103C,4,275148,276581,1433,-,Verified
POL3,YDL102W,4,276872,280165,3293,+,Verified
DUN1,YDL101C,4,280307,281848,1541,-,Verified
GET3,YDL100C,4,282112,283176,1064,-,Verified
BUG1,YDL099W,4,283419,284444,1025,+,Verified
SNU23,YDL098C,4,284581,285165,584,-,Verified
RPN6,YDL097C,4,285391,286695,1304,-,Verified
OPI6,YDL096C,4,286998,287324,326,-,Dubious
PMT1,YDL095W,4,287059,289512,2453,+,Verified
YDL094C,YDL094C,4,289572,290081,509,-,Dubious
PMT5,YDL093W,4,289909,292140,2231,+,Verified
SRP14,YDL092W,4,292781,293221,440,+,Verified
UBX3,YDL091C,4,293392,294759,1367,-,Verified
RAM1,YDL090C,4,295034,296329,1295,-,Verified
YDL089W,YDL089W,4,296820,298274,1454,+,Uncharacterized
ASM4,YDL088C,4,298417,300003,1586,-,Verified
LUC7,YDL087C,4,300214,300999,785,-,Verified
YDL086W,YDL086W,4,301413,302234,821,+,Uncharacterized
YDL086C-A,YDL086C-A,4,301655,302089,434,-,Dubious
YDL085C-A,YDL085C-A,4,302464,302670,206,-,Uncharacterized
NDE2,YDL085W,4,303211,304848,1637,+,Verified
SUB2,YDL084W,4,305237,306577,1340,+,Verified
RPS16B,YDL083C,4,306926,307789,863,-,Verified
RPL13A,YDL082W,4,308424,309388,964,+,Verified
RPP1A,YDL081C,4,309802,310122,320,-,Verified
THI3,YDL080C,4,310642,312471,1829,-,Verified
MRK1,YDL079C,4,312951,314748,1797,-,Verified
MDH3,YDL078C,4,315357,316388,1031,-,Verified
VAM6,YDL077C,4,316971,320120,3149,-,Verified
RXT3,YDL076C,4,320668,321552,884,-,Verified
RPL31A,YDL075W,4,322226,322988,762,+,Verified
BRE1,YDL074C,4,324047,326149,2102,-,Verified
YDL073W,YDL073W,4,326613,329567,2954,+,Uncharacterized
YET3,YDL072C,4,329836,330447,611,-,Verified
YDL071C,YDL071C,4,330667,331041,374,-,Dubious
BDF2,YDL070W,4,331025,332941,1916,+,Verified
CBS1,YDL069C,4,333121,333810,689,-,Verified
YDL068W,YDL068W,4,333500,333829,329,+,Dubious
COX9,YDL067C,4,334217,334396,179,-,Verified
IDP1,YDL066W,4,334835,336121,1286,+,Verified
PEX19,YDL065C,4,336249,337277,1028,-,Verified
UBC9,YDL064W,4,337487,338070,583,+,Verified
YDL063C,YDL063C,4,338272,340134,1862,-,Uncharacterized
YDL062W,YDL062W,4,339857,340282,425,+,Dubious
RPS29B,YDL061C,4,340628,341219,591,-,Verified
TSR1,YDL060W,4,341619,343985,2366,+,Verified
RAD59,YDL059C,4,344237,344953,716,-,Verified
USO1,YDL058W,4,345665,351037,5372,+,Verified
YDL057W,YDL057W,4,351434,352420,986,+,Uncharacterized
MBP1,YDL056W,4,352877,355378,2501,+,Verified
PSA1,YDL055C,4,355674,356759,1085,-,Verified
MCH1,YDL054C,4,359825,361285,1460,-,Verified
PBP4,YDL053C,4,361699,362256,557,-,Verified
SLC1,YDL052C,4,362672,363583,911,-,Verified
LHP1,YDL051W,4,363952,364779,827,+,Verified
YDL050C,YDL050C,4,364446,364817,371,-,Dubious
KNH1,YDL049C,4,365068,365874,806,-,Verified
STP4,YDL048C,4,366739,368211,1472,-,Verified
SIT4,YDL047W,4,369769,370704,935,+,Verified
NPC2,YDL046W,4,371237,371758,521,+,Verified
MRP10,YDL045W-A,4,372245,372532,287,+,Verified
FAD1,YDL045C,4,372685,373605,920,-,Verified
MTF2,YDL044C,4,373964,375286,1322,-,Verified
PRP11,YDL043C,4,375677,376477,800,-,Verified
SIR2,YDL042C,4,376754,378442,1688,-,Verified
YDL041W,YDL041W,4,378099,378452,353,+,Dubious
NAT1,YDL040C,4,378871,381435,2564,-,Verified
PRM7,YDL039C,4,381983,384079,2096,-,Verified
BSC1,YDL037C,4,384599,385585,986,-,Verified
PUS9,YDL036C,4,387511,388899,1388,-,Verified
GPR1,YDL035C,4,389170,392055,2885,-,Verified
YDL034W,YDL034W,4,391781,392125,344,+,Dubious
SLM3,YDL033C,4,392657,393910,1253,-,Verified
YDL032W,YDL032W,4,393688,393999,311,+,Dubious
DBP10,YDL031W,4,394215,397202,2987,+,Verified
PRP9,YDL030W,4,397535,399127,1592,+,Verified
ARP2,YDL029W,4,399338,400636,1298,+,Verified
MPS1,YDL028C,4,400995,403289,2294,-,Verified
YDL027C,YDL027C,4,403693,404955,1262,-,Uncharacterized
YDL026W,YDL026W,4,404747,405058,311,+,Dubious
YDL025C,YDL025C,4,405342,407204,1862,-,Uncharacterized
YDL025W-A,YDL025W-A,4,405408,405512,104,+,Dubious
DIA3,YDL024C,4,408449,409855,1406,-,Verified
YDL022C-A,YDL022C-A,4,409806,410054,248,-,Dubious
YDL023C,YDL023C,4,411759,412079,320,-,Dubious
GPD1,YDL022W,4,411823,412998,1175,+,Verified
GPM2,YDL021W,4,413951,414886,935,+,Verified
RPN4,YDL020C,4,415111,416706,1595,-,Verified
OSH2,YDL019C,4,417661,421512,3851,-,Verified
ERP3,YDL018C,4,422831,423508,677,-,Verified
CDC7,YDL017W,4,424207,425730,1523,+,Verified
YDL016C,YDL016C,4,425568,425870,302,-,Dubious
TSC13,YDL015C,4,426000,426932,932,-,Verified
NOP1,YDL014W,4,427362,428345,983,+,Verified
SLX5,YDL013W,4,429065,430924,1859,+,Verified
YDL012C,YDL012C,4,431106,431515,409,-,Uncharacterized
YDL011C,YDL011C,4,432306,432629,323,-,Dubious
GRX6,YDL010W,4,432328,433023,695,+,Verified
YDL009C,YDL009C,4,432923,433246,323,-,Dubious
APC11,YDL008W,4,433495,433992,497,+,Verified
YDL007C-A,YDL007C-A,4,436565,436822,257,-,Uncharacterized
RPT2,YDL007W,4,438045,439358,1313,+,Verified
PTC1,YDL006W,4,439907,440752,845,+,Verified
MED2,YDL005C,4,441012,442307,1295,-,Verified
ATP16,YDL004W,4,443027,443509,482,+,Verified
MCD1,YDL003W,4,444681,446381,1700,+,Verified
NHP10,YDL002C,4,446965,447576,611,-,Verified
RMD1,YDL001W,4,447982,449274,1292,+,Verified
NTH1,YDR001C,4,450218,452473,2255,-,Verified
YRB1,YDR002W,4,453043,453648,605,+,Verified
RCR2,YDR003W,4,454120,454752,632,+,Verified
YDR003W-A,YDR003W-A,4,454780,454902,122,+,Uncharacterized
RAD57,YDR004W,4,455199,456581,1382,+,Verified
MAF1,YDR005C,4,456834,458101,1267,-,Verified
SOK1,YDR006C,4,458540,461245,2705,-,Verified
TRP1,YDR007W,4,461840,462514,674,+,Verified
YDR008C,YDR008C,4,462250,462600,350,-,Dubious
GAL3,YDR009W,4,463432,464994,1562,+,Verified
YDR010C,YDR010C,4,465049,465381,332,-,Dubious
SNQ2,YDR011W,4,465917,470422,4505,+,Verified
RPL4B,YDR012W,4,471851,472939,1088,+,Verified
PSF1,YDR013W,4,473155,473781,626,+,Verified
RAD61,YDR014W,4,474044,475987,1943,+,Verified
HED1,YDR014W-A,4,477795,478283,488,+,Verified
YDR015C,YDR015C,4,477958,478197,239,-,Dubious
DAD1,YDR016C,4,478472,478756,284,-,Verified
KCS1,YDR017C,4,479113,482265,3152,-,Verified
YDR018C,YDR018C,4,482668,483858,1190,-,Uncharacterized
GCV1,YDR019C,4,484161,485363,1202,-,Verified
DAS2,YDR020C,4,485744,486442,698,-,Uncharacterized
FAL1,YDR021W,4,486802,488001,1199,+,Verified
CIS1,YDR022C,4,488070,488660,590,-,Verified
SES1,YDR023W,4,489506,490894,1388,+,Verified
FYV1,YDR024W,4,491015,491500,485,+,Dubious
RPS11A,YDR025W,4,491513,492322,809,+,Verified
YDR026C,YDR026C,4,492554,494266,1712,-,Verified
VPS54,YDR027C,4,494647,497316,2669,-,Verified
REG1,YDR028C,4,497833,500877,3044,-,Verified
YDR029W,YDR029W,4,501098,501412,314,+,Dubious
RAD28,YDR030C,4,501751,503271,1520,-,Verified
MIC14,YDR031W,4,503496,503861,365,+,Verified
PST2,YDR032C,4,504097,504693,596,-,Verified
MRH1,YDR033W,4,508145,509107,962,+,Verified
LYS14,YDR034C,4,509735,512107,2372,-,Verified
YDR034C-A,YDR034C-A,4,520514,520690,176,-,Uncharacterized
YDR034W-B,YDR034W-B,4,521312,521467,155,+,Uncharacterized
ARO3,YDR035W,4,521814,522926,1112,+,Verified
EHD3,YDR036C,4,523209,524711,1502,-,Verified
KRS1,YDR037W,4,525438,527213,1775,+,Verified
ENA5,YDR038C,4,527420,530695,3275,-,Verified
ENA2,YDR039C,4,531305,534580,3275,-,Verified
ENA1,YDR040C,4,535190,538465,3275,-,Verified
RSM10,YDR041W,4,539801,540412,611,+,Verified
YDR042C,YDR042C,4,540599,541201,602,-,Uncharacterized
NRG1,YDR043C,4,542673,543368,695,-,Verified
HEM13,YDR044W,4,546641,547627,986,+,Verified
RPC11,YDR045C,4,547977,548309,332,-,Verified
BAP3,YDR046C,4,548761,550575,1814,-,Verified
HEM12,YDR047W,4,551859,552947,1088,+,Verified
YDR048C,YDR048C,4,553083,553397,314,-,Dubious
YDR049W,YDR049W,4,553253,555151,1898,+,Uncharacterized
TPI1,YDR050C,4,555725,556471,746,-,Verified
YDR051C,YDR051C,4,557055,558059,1004,-,Uncharacterized
DBF4,YDR052C,4,558510,560624,2114,-,Verified
YDR053W,YDR053W,4,560248,560643,395,+,Dubious
CDC34,YDR054C,4,561439,562326,887,-,Verified
PST1,YDR055W,4,563526,564860,1334,+,Verified
YDR056C,YDR056C,4,565022,565639,617,-,Uncharacterized
YOS9,YDR057W,4,565926,567554,1628,+,Verified
TGL2,YDR058C,4,567722,568702,980,-,Verified
UBC5,YDR059C,4,569233,569769,536,-,Verified
MAK21,YDR060W,4,570647,573724,3077,+,Verified
YDR061W,YDR061W,4,574162,575781,1619,+,Uncharacterized
LCB2,YDR062W,4,576472,578157,1685,+,Verified
AIM7,YDR063W,4,578662,579111,449,+,Uncharacterized
RPS13,YDR064W,4,579457,580451,994,+,Verified
YDR065W,YDR065W,4,580686,581783,1097,+,Uncharacterized
RTR2,YDR066C,4,581907,582497,590,-,Uncharacterized
OCA6,YDR067C,4,582790,583464,674,-,Uncharacterized
DOS2,YDR068W,4,583712,584644,932,+,Verified
DOA4,YDR069C,4,584938,587718,2780,-,Verified
FMP16,YDR070C,4,588097,588378,281,-,Uncharacterized
PAA1,YDR071C,4,588826,589401,575,-,Verified
IPT1,YDR072C,4,589760,591343,1583,-,Verified
SNF11,YDR073W,4,592437,592946,509,+,Verified
TPS2,YDR074W,4,593891,596581,2690,+,Verified
PPH3,YDR075W,4,597154,598080,926,+,Verified
RAD55,YDR076W,4,598466,599686,1220,+,Verified
SED1,YDR077W,4,600791,601807,1016,+,Verified
SHU2,YDR078C,4,602196,602867,671,-,Verified
PET100,YDR079W,4,603062,603397,335,+,Verified
TFB5,YDR079C-A,4,603591,603809,218,-,Verified
VPS41,YDR080W,4,604006,606984,2978,+,Verified
PDC2,YDR081C,4,607302,610079,2777,-,Verified
STN1,YDR082W,4,610439,611923,1484,+,Verified
RRP8,YDR083W,4,612071,613249,1178,+,Verified
TVP23,YDR084C,4,613403,614002,599,-,Verified
AFR1,YDR085C,4,614286,616148,1862,-,Verified
SSS1,YDR086C,4,616926,617168,242,-,Verified
RRP1,YDR087C,4,617468,618304,836,-,Verified
SLU7,YDR088C,4,618495,619643,1148,-,Verified
YDR089W,YDR089W,4,622110,624719,2609,+,Uncharacterized
YDR090C,YDR090C,4,625064,625996,932,-,Uncharacterized
RLI1,YDR091C,4,626706,628532,1826,-,Verified
UBC13,YDR092W,4,629874,630603,729,+,Verified
DNF2,YDR093W,4,631280,636118,4838,+,Verified
YDR094W,YDR094W,4,635838,636173,335,+,Dubious
YDR095C,YDR095C,4,636115,636525,410,-,Dubious
GIS1,YDR096W,4,637137,639821,2684,+,Verified
MSH6,YDR097C,4,640107,643835,3728,-,Verified
GRX3,YDR098C,4,644176,645033,857,-,Verified
BMH2,YDR099W,4,652779,654426,1647,+,Verified
TVP15,YDR100W,4,655011,655442,431,+,Verified
ARX1,YDR101C,4,655684,657465,1781,-,Verified
YDR102C,YDR102C,4,657646,657978,332,-,Dubious
STE5,YDR103W,4,658348,661101,2753,+,Verified
SPO71,YDR104C,4,661171,664908,3737,-,Verified
TMS1,YDR105C,4,665347,666768,1421,-,Verified
ARP10,YDR106W,4,667002,667856,854,+,Verified
TMN2,YDR107C,4,669014,671032,2018,-,Verified
GSG1,YDR108W,4,671267,673363,2096,+,Verified
YDR109C,YDR109C,4,673518,675665,2147,-,Uncharacterized
FOB1,YDR110W,4,676100,677800,1700,+,Verified
ALT2,YDR111C,4,678239,679762,1523,-,Uncharacterized
IRC2,YDR112W,4,679542,679850,308,+,Dubious
PDS1,YDR113C,4,680494,681615,1121,-,Verified
YDR114C,YDR114C,4,681922,682224,302,-,Uncharacterized
YDR115W,YDR115W,4,682173,682490,317,+,Uncharacterized
MRPL1,YDR116C,4,682722,683579,857,-,Verified
TMA64,YDR117C,4,683944,685641,1697,-,Verified
APC4,YDR118W,4,685880,687838,1958,+,Verified
YDR118W-A,YDR118W-A,4,687766,687882,116,+,Dubious
VBA4,YDR119W,4,688225,690531,2306,+,Uncharacterized
YDR119W-A,YDR119W-A,4,691012,691212,200,+,Uncharacterized
TRM1,YDR120C,4,691547,693259,1712,-,Verified
DPB4,YDR121W,4,693583,694173,590,+,Verified
KIN1,YDR122W,4,694698,697892,3194,+,Verified
INO2,YDR123C,4,698552,699466,914,-,Verified
YDR124W,YDR124W,4,700313,701287,974,+,Uncharacterized
ECM18,YDR125C,4,701395,702756,1361,-,Verified
SWF1,YDR126W,4,703232,704242,1010,+,Verified
ARO1,YDR127W,4,704482,709248,4766,+,Verified
MTC5,YDR128W,4,709547,712993,3446,+,Uncharacterized
SAC6,YDR129C,4,713338,715377,2039,-,Verified
FIN1,YDR130C,4,715745,716620,875,-,Verified
YDR131C,YDR131C,4,716788,718458,1670,-,Uncharacterized
YDR132C,YDR132C,4,718814,720301,1487,-,Uncharacterized
YDR133C,YDR133C,4,720960,721295,335,-,Dubious
YCF1,YDR135C,4,723002,727549,4547,-,Verified
VPS61,YDR136C,4,727709,728281,572,-,Dubious
RGP1,YDR137W,4,728257,730248,1991,+,Verified
HPR1,YDR138W,4,730576,732834,2258,+,Verified
RUB1,YDR139C,4,733616,733922,306,-,Verified
MTQ2,YDR140W,4,734136,734801,665,+,Verified
DOP1,YDR141C,4,734899,739995,5096,-,Verified
PEX7,YDR142C,4,740471,741598,1127,-,Verified
SAN1,YDR143C,4,742040,743872,1832,-,Verified
MKC7,YDR144C,4,744309,746099,1790,-,Verified
TAF12,YDR145W,4,746736,748355,1619,+,Verified
SWI5,YDR146C,4,748611,750740,2129,-,Verified
EKI1,YDR147W,4,751629,753233,1604,+,Verified
KGD2,YDR148C,4,753673,755064,1391,-,Verified
YDR149C,YDR149C,4,755553,756260,707,-,Dubious
NUM1,YDR150W,4,755626,763872,8246,+,Verified
CTH1,YDR151C,4,764176,765153,977,-,Verified
GIR2,YDR152W,4,765704,766501,797,+,Verified
ENT5,YDR153C,4,766734,767969,1235,-,Verified
YDR154C,YDR154C,4,768401,768751,350,-,Dubious
CPR1,YDR155C,4,768510,768998,488,-,Verified
RPA14,YDR156W,4,769523,769936,413,+,Verified
YDR157W,YDR157W,4,769929,770330,401,+,Dubious
HOM2,YDR158W,4,770355,771452,1097,+,Verified
SAC3,YDR159W,4,771875,775780,3905,+,Verified
SSY1,YDR160W,4,776161,778719,2558,+,Verified
YDR161W,YDR161W,4,779041,780204,1163,+,Uncharacterized
NBP2,YDR162C,4,780388,781098,710,-,Verified
CWC15,YDR163W,4,781421,781948,527,+,Verified
SEC1,YDR164C,4,782039,784213,2174,-,Verified
TRM82,YDR165W,4,784869,786203,1334,+,Verified
SEC5,YDR166C,4,786304,789219,2915,-,Verified
TAF10,YDR167W,4,789447,790067,620,+,Verified
CDC37,YDR168W,4,790326,791846,1520,+,Verified
STB3,YDR169C,4,792346,793887,1541,-,Verified
YDR169C-A,YDR169C-A,4,794572,794721,149,-,Uncharacterized
SEC7,YDR170C,4,796191,802220,6029,-,Verified
HSP42,YDR171W,4,806619,807746,1127,+,Verified
SUP35,YDR172W,4,808322,810379,2057,+,Verified
ARG82,YDR173C,4,810563,811630,1067,-,Verified
HMO1,YDR174W,4,812108,812848,740,+,Verified
RSM24,YDR175C,4,813191,814150,959,-,Verified
NGG1,YDR176W,4,814450,816558,2108,+,Verified
UBC1,YDR177W,4,816876,817523,647,+,Verified
SDH4,YDR178W,4,817948,818493,545,+,Verified
CSN9,YDR179C,4,818706,819194,488,-,Verified
YDR179W-A,YDR179W-A,4,819431,820822,1391,+,Uncharacterized
SCC2,YDR180W,4,821293,825774,4481,+,Verified
SAS4,YDR181C,4,825908,827353,1445,-,Verified
CDC1,YDR182W,4,827580,829055,1475,+,Verified
YDR182W-A,YDR182W-A,4,829149,829352,203,+,Uncharacterized
PLP1,YDR183W,4,829583,830275,692,+,Verified
YDR183C-A,YDR183C-A,4,830395,830652,257,-,Dubious
ATC1,YDR184C,4,830627,831511,884,-,Verified
YDR185C,YDR185C,4,831932,832471,539,-,Uncharacterized
YDR186C,YDR186C,4,832857,835490,2633,-,Verified
YDR187C,YDR187C,4,836226,836744,518,-,Dubious
CCT6,YDR188W,4,836419,838059,1640,+,Verified
SLY1,YDR189W,4,838390,840390,2000,+,Verified
RVB1,YDR190C,4,840602,841993,1391,-,Verified
HST4,YDR191W,4,842335,843447,1112,+,Verified
NUP42,YDR192C,4,843567,844859,1292,-,Verified
YDR193W,YDR193W,4,844552,844950,398,+,Dubious
MSS116,YDR194C,4,845950,847944,1994,-,Verified
YDR194W-A,YDR194W-A,4,848069,848221,152,+,Uncharacterized
REF2,YDR195W,4,848597,850198,1601,+,Verified
YDR196C,YDR196C,4,850272,850997,725,-,Uncharacterized
CBS2,YDR197W,4,851226,852395,1169,+,Verified
RKM2,YDR198C,4,852531,853970,1439,-,Verified
YDR199W,YDR199W,4,854173,854538,365,+,Dubious
VPS64,YDR200C,4,854277,856091,1814,-,Verified
SPC19,YDR201W,4,856315,856812,497,+,Verified
RAV2,YDR202C,4,856896,857951,1055,-,Verified
YDR203W,YDR203W,4,857680,857997,317,+,Dubious
COQ4,YDR204W,4,858135,859142,1007,+,Verified
MSC2,YDR205W,4,859344,861518,2174,+,Verified
EBS1,YDR206W,4,862052,864706,2654,+,Verified
UME6,YDR207C,4,865010,867520,2510,-,Verified
MSS4,YDR208W,4,868222,870561,2339,+,Verified
YDR209C,YDR209C,4,871034,871447,413,-,Dubious
YDR210W,YDR210W,4,871072,871299,227,+,Uncharacterized
GCD6,YDR211W,4,884725,886863,2138,+,Verified
TCP1,YDR212W,4,887230,888909,1679,+,Verified
UPC2,YDR213W,4,889749,892490,2741,+,Verified
AHA1,YDR214W,4,892873,893925,1052,+,Verified
YDR215C,YDR215C,4,894116,894499,383,-,Dubious
ADR1,YDR216W,4,895032,899003,3971,+,Verified
RAD9,YDR217C,4,899548,903477,3929,-,Verified
SPR28,YDR218C,4,903778,905049,1271,-,Verified
MFB1,YDR219C,4,905452,906849,1397,-,Verified
YDR220C,YDR220C,4,906997,907290,293,-,Dubious
GTB1,YDR221W,4,907327,909435,2108,+,Verified
YDR222W,YDR222W,4,910051,911298,1247,+,Uncharacterized
CRF1,YDR223W,4,912096,913499,1403,+,Verified
HTB1,YDR224C,4,914314,914709,395,-,Verified
HTA1,YDR225W,4,915527,915925,398,+,Verified
ADK1,YDR226W,4,916483,917151,668,+,Verified
SIR4,YDR227W,4,917568,921644,4076,+,Verified
PCF11,YDR228C,4,921923,923803,1880,-,Verified
IVY1,YDR229W,4,924782,926143,1361,+,Verified
YDR230W,YDR230W,4,926220,926567,347,+,Dubious
COX20,YDR231C,4,926290,926907,617,-,Verified
HEM1,YDR232W,4,927449,929095,1646,+,Verified
RTN1,YDR233C,4,929467,930354,887,-,Verified
LYS4,YDR234W,4,931126,933207,2081,+,Verified
PRP42,YDR235W,4,933501,935135,1634,+,Verified
FMN1,YDR236C,4,935233,935889,656,-,Verified
MRPL7,YDR237W,4,936612,937490,878,+,Verified
SEC26,YDR238C,4,937892,940813,2921,-,Verified
YDR239C,YDR239C,4,941054,943417,2363,-,Verified
SNU56,YDR240C,4,943671,945149,1478,-,Verified
BUD26,YDR241W,4,945148,945435,287,+,Dubious
AMD2,YDR242W,4,946804,948453,1649,+,Verified
PRP28,YDR243C,4,948515,950281,1766,-,Verified
PEX5,YDR244W,4,950560,952398,1838,+,Verified
MNN10,YDR245W,4,952797,953978,1181,+,Verified
TRS23,YDR246W,4,954285,954944,659,+,Verified
YDR246W-A,YDR246W-A,4,955130,955330,200,+,Uncharacterized
VHS1,YDR247W,4,956010,957395,1385,+,Verified
YDR248C,YDR248C,4,957755,958336,581,-,Uncharacterized
YDR249C,YDR249C,4,958678,959799,1121,-,Uncharacterized
YDR250C,YDR250C,4,960083,960358,275,-,Dubious
PAM1,YDR251W,4,960611,963103,2492,+,Verified
BTT1,YDR252W,4,963409,963858,449,+,Verified
MET32,YDR253C,4,963987,964562,575,-,Verified
CHL4,YDR254W,4,965110,966486,1376,+,Verified
RMD5,YDR255C,4,966554,967819,1265,-,Verified
CTA1,YDR256C,4,968130,969677,1547,-,Verified
SET7,YDR257C,4,969987,971471,1484,-,Verified
HSP78,YDR258C,4,971805,974240,2435,-,Verified
YAP6,YDR259C,4,974628,975779,1151,-,Verified
SWM1,YDR260C,4,976714,977226,512,-,Verified
EXG2,YDR261C,4,977518,979206,1688,-,Verified
YDR262W,YDR262W,4,993131,993949,818,+,Uncharacterized
DIN7,YDR263C,4,994239,995531,1292,-,Verified
AKR1,YDR264C,4,996026,998320,2294,-,Verified
PEX10,YDR265W,4,998861,999874,1013,+,Verified
YDR266C,YDR266C,4,1000101,1002020,1919,-,Verified
CIA1,YDR267C,4,1002507,1003499,992,-,Verified
MSW1,YDR268W,4,1004001,1005140,1139,+,Verified
YDR269C,YDR269C,4,1005662,1005985,323,-,Dubious
CCC2,YDR270W,4,1005672,1008686,3014,+,Verified
YDR271C,YDR271C,4,1008392,1008763,371,-,Dubious
GLO2,YDR272W,4,1009007,1009831,824,+,Verified
DON1,YDR273W,4,1010173,1011270,1097,+,Verified
YDR274C,YDR274C,4,1011586,1011957,371,-,Dubious
BSC2,YDR275W,4,1012249,1012956,707,+,Verified
PMP3,YDR276C,4,1013473,1013640,167,-,Verified
MTH1,YDR277C,4,1014398,1015699,1301,-,Verified
YDR278C,YDR278C,4,1016998,1017315,317,-,Dubious
RNH202,YDR279W,4,1019365,1020417,1052,+,Verified
RRP45,YDR280W,4,1020744,1021661,917,+,Verified
PHM6,YDR281C,4,1022004,1022318,314,-,Verified
YDR282C,YDR282C,4,1023508,1024752,1244,-,Uncharacterized
GCN2,YDR283C,4,1025067,1030046,4979,-,Verified
DPP1,YDR284C,4,1030547,1031416,869,-,Verified
ZIP1,YDR285W,4,1032433,1035060,2627,+,Verified
YDR286C,YDR286C,4,1035228,1035572,344,-,Uncharacterized
INM2,YDR287W,4,1035992,1036870,878,+,Verified
NSE3,YDR288W,4,1037192,1038103,911,+,Verified
RTT103,YDR289C,4,1038277,1039506,1229,-,Verified
YDR290W,YDR290W,4,1039367,1039696,329,+,Dubious
HRQ1,YDR291W,4,1039725,1042958,3233,+,Uncharacterized
SRP101,YDR292C,4,1043143,1045008,1865,-,Verified
SSD1,YDR293C,4,1045637,1049389,3752,-,Verified
DPL1,YDR294C,4,1050456,1052225,1769,-,Verified
HDA2,YDR295C,4,1052620,1054644,2024,-,Verified
MHR1,YDR296W,4,1055209,1055889,680,+,Verified
SUR2,YDR297W,4,1056548,1057597,1049,+,Verified
ATP5,YDR298C,4,1058173,1058811,638,-,Verified
BFR2,YDR299W,4,1059624,1061228,1604,+,Verified
PRO1,YDR300C,4,1061502,1062788,1286,-,Verified
CFT1,YDR301W,4,1063349,1067422,4073,+,Verified
GPI11,YDR302W,4,1067728,1068387,659,+,Verified
RSC3,YDR303C,4,1068726,1071383,2657,-,Verified
CPR5,YDR304C,4,1071877,1072554,677,-,Verified
HNT2,YDR305C,4,1072743,1073485,742,-,Verified
YDR306C,YDR306C,4,1073732,1075168,1436,-,Uncharacterized
YDR307W,YDR307W,4,1075862,1077850,1988,+,Uncharacterized
SRB7,YDR308C,4,1078024,1078446,422,-,Verified
GIC2,YDR309C,4,1079045,1080196,1151,-,Verified
SUM1,YDR310C,4,1081125,1084313,3188,-,Verified
TFB1,YDR311W,4,1085063,1086991,1928,+,Verified
SSF2,YDR312W,4,1087579,1088940,1361,+,Verified
PIB1,YDR313C,4,1089217,1090077,860,-,Verified
RAD34,YDR314C,4,1090431,1092509,2078,-,Verified
IPK1,YDR315C,4,1092739,1093584,845,-,Verified
OMS1,YDR316W,4,1093761,1095176,1415,+,Verified
HIM1,YDR317W,4,1102182,1103426,1244,+,Verified
MCM21,YDR318W,4,1103756,1104945,1189,+,Verified
YFT2,YDR319C,4,1105001,1105825,824,-,Uncharacterized
SWA2,YDR320C,4,1106093,1108099,2006,-,Verified
DAD4,YDR320C-A,4,1108278,1108496,218,-,Verified
YDR320W-B,YDR320W-B,4,1108482,1108619,137,+,Dubious
ASP1,YDR321W,4,1108700,1109845,1145,+,Verified
MRPL35,YDR322W,4,1110587,1111690,1103,+,Verified
TIM11,YDR322C-A,4,1112001,1112291,290,-,Verified
PEP7,YDR323C,4,1112478,1114025,1547,-,Verified
UTP4,YDR324C,4,1114431,1116761,2330,-,Verified
YCG1,YDR325W,4,1117122,1120229,3107,+,Verified
YSP2,YDR326C,4,1120605,1124921,4316,-,Verified
YDR327W,YDR327W,4,1125298,1125624,326,+,Dubious
SKP1,YDR328C,4,1125430,1126014,584,-,Verified
PEX3,YDR329C,4,1126266,1127591,1325,-,Verified
UBX5,YDR330W,4,1127868,1129370,1502,+,Verified
GPI8,YDR331W,4,1129584,1130819,1235,+,Verified
IRC3,YDR332W,4,1130997,1133066,2069,+,Verified
YDR333C,YDR333C,4,1133256,1135427,2171,-,Uncharacterized
SWR1,YDR334W,4,1135928,1140472,4544,+,Verified
MSN5,YDR335W,4,1141163,1144837,3674,+,Verified
YDR336W,YDR336W,4,1145087,1146031,944,+,Uncharacterized
MRPS28,YDR337W,4,1146314,1147174,860,+,Verified
YDR338C,YDR338C,4,1147374,1149461,2087,-,Uncharacterized
FCF1,YDR339C,4,1149946,1150515,569,-,Verified
YDR340W,YDR340W,4,1150876,1151178,302,+,Dubious
YDR341C,YDR341C,4,1151798,1153621,1823,-,Verified
HXT7,YDR342C,4,1154211,1155923,1712,-,Verified
HXT6,YDR343C,4,1159603,1161315,1712,-,Verified
YDR344C,YDR344C,4,1162001,1162444,443,-,Dubious
HXT3,YDR345C,4,1162952,1164655,1703,-,Verified
SVF1,YDR346C,4,1167209,1168654,1445,-,Verified
MRP1,YDR347W,4,1169173,1170138,965,+,Verified
YDR348C,YDR348C,4,1170321,1171820,1499,-,Uncharacterized
YPS7,YDR349C,4,1172381,1174171,1790,-,Verified
ATP22,YDR350C,4,1176333,1178168,1835,-,Verified
SBE2,YDR351W,4,1178660,1181254,2594,+,Verified
YDR352W,YDR352W,4,1181795,1182748,953,+,Uncharacterized
TRR1,YDR353W,4,1183293,1184252,959,+,Verified
TRP4,YDR354W,4,1184741,1185883,1142,+,Verified
YDR354C-A,YDR354C-A,4,1185133,1185276,143,-,Dubious
YDR355C,YDR355C,4,1186061,1186363,302,-,Dubious
SPC110,YDR356W,4,1186101,1188935,2834,+,Verified
YDR357C,YDR357C,4,1189193,1189561,368,-,Uncharacterized
GGA1,YDR358W,4,1190053,1191726,1673,+,Verified
EAF1,YDR359C,4,1191930,1194878,2948,-,Verified
OPI7,YDR360W,4,1194592,1194978,386,+,Dubious
BCP1,YDR361C,4,1195405,1196256,851,-,Verified
TFC6,YDR362C,4,1196672,1198690,2018,-,Verified
ESC2,YDR363W,4,1199176,1200546,1370,+,Verified
SEM1,YDR363W-A,4,1202121,1202390,269,+,Verified
CDC40,YDR364C,4,1202836,1204203,1367,-,Verified
ESF1,YDR365C,4,1204490,1206376,1886,-,Verified
YDR366C,YDR366C,4,1212431,1212829,398,-,Uncharacterized
KEI1,YDR367W,4,1212841,1213607,766,+,Uncharacterized
YPR1,YDR368W,4,1213897,1214835,938,+,Verified
XRS2,YDR369C,4,1215009,1217573,2564,-,Verified
YDR370C,YDR370C,4,1217775,1219103,1328,-,Uncharacterized
CTS2,YDR371W,4,1219406,1220941,1535,+,Uncharacterized
YDR371C-A,YDR371C-A,4,1219502,1219606,104,-,Dubious
VPS74,YDR372C,4,1221105,1222142,1037,-,Verified
FRQ1,YDR373W,4,1222752,1223324,572,+,Verified
YDR374C,YDR374C,4,1223467,1224387,920,-,Uncharacterized
YDR374W-A,YDR374W-A,4,1224750,1225019,269,+,Uncharacterized
BCS1,YDR375C,4,1225159,1226529,1370,-,Verified
ARH1,YDR376W,4,1226815,1228296,1481,+,Verified
ATP17,YDR377W,4,1228604,1228909,305,+,Verified
LSM6,YDR378C,4,1229342,1229602,260,-,Verified
RGA2,YDR379W,4,1230160,1233189,3029,+,Verified
YDR379C-A,YDR379C-A,4,1233271,1233510,239,-,Uncharacterized
ARO10,YDR380W,4,1234211,1236118,1907,+,Verified
YRA1,YDR381W,4,1236551,1237997,1446,+,Verified
YDR381C-A,YDR381C-A,4,1238305,1238843,538,-,Verified
RPP2B,YDR382W,4,1239485,1239817,332,+,Verified
NKP1,YDR383C,4,1239953,1240669,716,-,Verified
ATO3,YDR384C,4,1241197,1242024,827,-,Verified
EFT2,YDR385W,4,1243223,1245751,2528,+,Verified
MUS81,YDR386W,4,1246077,1247975,1898,+,Verified
YDR387C,YDR387C,4,1248147,1249814,1667,-,Uncharacterized
RVS167,YDR388W,4,1250179,1251627,1448,+,Verified
SAC7,YDR389W,4,1252530,1254494,1964,+,Verified
UBA2,YDR390C,4,1254930,1256840,1910,-,Verified
YDR391C,YDR391C,4,1257351,1258049,698,-,Uncharacterized
SPT3,YDR392W,4,1258689,1259702,1013,+,Verified
SHE9,YDR393W,4,1259894,1261264,1370,+,Verified
RPT3,YDR394W,4,1261674,1262960,1286,+,Verified
SXM1,YDR395W,4,1263317,1266151,2834,+,Verified
YDR396W,YDR396W,4,1266288,1266788,500,+,Dubious
NCB2,YDR397C,4,1266359,1266891,532,-,Verified
UTP5,YDR398W,4,1267464,1269395,1931,+,Verified
HPT1,YDR399W,4,1270061,1270726,665,+,Verified
URH1,YDR400W,4,1271056,1272078,1022,+,Verified
YDR401W,YDR401W,4,1272216,1272779,563,+,Dubious
DIT2,YDR402C,4,1272227,1273696,1469,-,Verified
DIT1,YDR403W,4,1274595,1276205,1610,+,Verified
RPB7,YDR404C,4,1276647,1277162,515,-,Verified
MRP20,YDR405W,4,1277639,1278430,791,+,Verified
PDR15,YDR406W,4,1279203,1283792,4589,+,Verified
YDR406W-A,YDR406W-A,4,1283792,1284037,245,+,Dubious
TRS120,YDR407C,4,1284062,1287931,3869,-,Verified
ADE8,YDR408C,4,1288208,1288852,644,-,Verified
SIZ1,YDR409W,4,1289399,1292113,2714,+,Verified
STE14,YDR410C,4,1292365,1293084,719,-,Verified
DFM1,YDR411C,4,1293362,1294387,1025,-,Verified
RRP17,YDR412W,4,1294686,1295393,707,+,Uncharacterized
YDR413C,YDR413C,4,1294829,1295404,575,-,Dubious
ERD1,YDR414C,4,1295591,1296679,1088,-,Verified
YDR415C,YDR415C,4,1297030,1298154,1124,-,Uncharacterized
SYF1,YDR416W,4,1298425,1301004,2579,+,Verified
YDR417C,YDR417C,4,1301548,1301919,371,-,Dubious
RPL12B,YDR418W,4,1301609,1302106,497,+,Verified
RAD30,YDR419W,4,1303167,1305065,1898,+,Verified
HKR1,YDR420W,4,1306260,1311668,5408,+,Verified
ARO80,YDR421W,4,1312033,1314885,2852,+,Verified
SIP1,YDR422C,4,1315319,1317766,2447,-,Verified
CAD1,YDR423C,4,1318039,1319268,1229,-,Verified
DYN2,YDR424C,4,1319380,1319834,454,-,Verified
SNX41,YDR425W,4,1320057,1321934,1877,+,Verified
YDR426C,YDR426C,4,1321622,1321999,377,-,Dubious
RPN9,YDR427W,4,1322198,1323379,1181,+,Verified
BNA7,YDR428C,4,1323447,1324232,785,-,Verified
TIF35,YDR429C,4,1324470,1325294,824,-,Verified
CYM1,YDR430C,4,1325494,1328463,2969,-,Verified
YDR431W,YDR431W,4,1328383,1328694,311,+,Dubious
NPL3,YDR432W,4,1328776,1330020,1244,+,Verified
YDR433W,YDR433W,4,1329593,1330033,440,+,Dubious
GPI17,YDR434W,4,1331230,1332834,1604,+,Verified
PPM1,YDR435C,4,1332976,1333962,986,-,Verified
PPZ2,YDR436W,4,1334814,1336946,2132,+,Verified
GPI19,YDR437W,4,1337345,1337767,422,+,Verified
THI74,YDR438W,4,1338267,1339379,1112,+,Verified
LRS4,YDR439W,4,1339669,1340712,1043,+,Verified
DOT1,YDR440W,4,1342486,1344234,1748,+,Verified
APT2,YDR441C,4,1344510,1345055,545,-,Verified
YDR442W,YDR442W,4,1345640,1346032,392,+,Dubious
SSN2,YDR443C,4,1345669,1349931,4262,-,Verified
YDR444W,YDR444W,4,1350283,1352346,2063,+,Uncharacterized
YDR445C,YDR445C,4,1352175,1352582,407,-,Dubious
ECM11,YDR446W,4,1353718,1354626,908,+,Verified
RPS17B,YDR447C,4,1354822,1355546,724,-,Verified
ADA2,YDR448W,4,1356058,1357362,1304,+,Verified
UTP6,YDR449C,4,1357573,1358895,1322,-,Verified
RPS18A,YDR450W,4,1359916,1360791,875,+,Verified
YHP1,YDR451C,4,1361113,1362174,1061,-,Verified
PPN1,YDR452W,4,1362871,1364895,2024,+,Verified
TSA2,YDR453C,4,1365065,1365655,590,-,Verified
GUK1,YDR454C,4,1366257,1366820,563,-,Verified
YDR455C,YDR455C,4,1367366,1367674,308,-,Dubious
NHX1,YDR456W,4,1367478,1369379,1901,+,Verified
TOM1,YDR457W,4,1369783,1379589,9806,+,Verified
HEH2,YDR458C,4,1380048,1382039,1991,-,Verified
PFA5,YDR459C,4,1382312,1383436,1124,-,Verified
TFB3,YDR460W,4,1383804,1384769,965,+,Verified
MFA1,YDR461W,4,1385169,1385279,110,+,Verified
YDR461C-A,YDR461C-A,4,1385517,1385759,242,-,Uncharacterized
MRPL28,YDR462W,4,1386066,1386509,443,+,Verified
STP1,YDR463W,4,1386809,1388368,1559,+,Verified
SPP41,YDR464W,4,1388865,1393172,4307,+,Verified
YDR464C-A,YDR464C-A,4,1392485,1392673,188,-,Dubious
RMT2,YDR465C,4,1393329,1394567,1238,-,Verified
PKH3,YDR466W,4,1395114,1397810,2696,+,Verified
YDR467C,YDR467C,4,1397576,1397902,326,-,Dubious
TLG1,YDR468C,4,1398019,1398693,674,-,Verified
SDC1,YDR469W,4,1399008,1399535,527,+,Verified
UGO1,YDR470C,4,1399699,1401207,1508,-,Verified
RPL27B,YDR471W,4,1401763,1402557,794,+,Verified
TRS31,YDR472W,4,1403315,1404166,851,+,Verified
PRP3,YDR473C,4,1404438,1405847,1409,-,Verified
JIP4,YDR475C,4,1407457,1410087,2630,-,Verified
YDR476C,YDR476C,4,1410446,1411120,674,-,Uncharacterized
SNF1,YDR477W,4,1412366,1414267,1901,+,Verified
SNM1,YDR478W,4,1414568,1415164,596,+,Verified
PEX29,YDR479C,4,1415203,1416867,1664,-,Verified
DIG2,YDR480W,4,1417392,1418363,971,+,Verified
PHO8,YDR481C,4,1418543,1420243,1700,-,Verified
CWC21,YDR482C,4,1420424,1420831,407,-,Verified
KRE2,YDR483W,4,1421150,1422478,1328,+,Verified
VPS52,YDR484W,4,1422756,1424681,1925,+,Verified
VPS72,YDR485C,4,1424813,1427200,2387,-,Verified
VPS60,YDR486C,4,1427424,1428113,689,-,Verified
RIB3,YDR487C,4,1428347,1428973,626,-,Verified
PAC11,YDR488C,4,1429181,1430782,1601,-,Verified
SLD5,YDR489W,4,1431005,1431889,884,+,Verified
PKH1,YDR490C,4,1431961,1434261,2300,-,Verified
YDR491C,YDR491C,4,1434493,1434984,491,-,Dubious
IZH1,YDR492W,4,1434917,1435867,950,+,Verified
AIM8,YDR493W,4,1436210,1436581,371,+,Uncharacterized
RSM28,YDR494W,4,1436923,1438008,1085,+,Verified
VPS3,YDR495C,4,1438108,1441143,3035,-,Verified
PUF6,YDR496C,4,1441426,1443396,1970,-,Verified
ITR1,YDR497C,4,1443706,1445460,1754,-,Verified
SEC20,YDR498C,4,1445836,1446987,1151,-,Verified
LCD1,YDR499W,4,1447823,1450066,2243,+,Verified
RPL37B,YDR500C,4,1450191,1450846,655,-,Verified
PLM2,YDR501W,4,1451346,1452911,1565,+,Verified
SAM2,YDR502C,4,1453303,1454457,1154,-,Verified
LPP1,YDR503C,4,1455035,1455859,824,-,Verified
SPG3,YDR504C,4,1456304,1456687,383,-,Verified
PSP1,YDR505C,4,1456688,1459213,2525,-,Verified
YDR506C,YDR506C,4,1459721,1461547,1826,-,Uncharacterized
GIN4,YDR507C,4,1462351,1465779,3428,-,Verified
GNP1,YDR508C,4,1466446,1468437,1991,-,Verified
YDR509W,YDR509W,4,1468219,1468566,347,+,Dubious
SMT3,YDR510W,4,1469393,1469698,305,+,Verified
YDR510C-A,YDR510C-A,4,1469688,1469804,116,-,Dubious
ACN9,YDR511W,4,1470010,1470411,401,+,Verified
EMI1,YDR512C,4,1470493,1471056,563,-,Verified
GRX2,YDR513W,4,1471010,1471441,431,+,Verified
YDR514C,YDR514C,4,1471541,1472992,1451,-,Uncharacterized
SLF1,YDR515W,4,1473422,1474765,1343,+,Verified
EMI2,YDR516C,4,1474967,1476469,1502,-,Verified
GRH1,YDR517W,4,1477232,1478350,1118,+,Verified
EUG1,YDR518W,4,1478601,1480154,1553,+,Verified
FPR2,YDR519W,4,1480418,1480825,407,+,Verified
URC2,YDR520C,4,1481078,1483396,2318,-,Uncharacterized
YDR521W,YDR521W,4,1483134,1483469,335,+,Dubious
SPS2,YDR522C,4,1483788,1485296,1508,-,Verified
SPS1,YDR523C,4,1485559,1487031,1472,-,Verified
AGE1,YDR524C,4,1487535,1488983,1448,-,Verified
YDR524W-C,YDR524W-C,4,1489396,1489485,89,+,Uncharacterized
YDR524C-B,YDR524C-B,4,1489591,1489791,200,-,Uncharacterized
YDR524C-A,YDR524C-A,4,1489864,1489983,119,-,Dubious
API2,YDR525W,4,1489898,1490227,329,+,Dubious
SNA2,YDR525W-A,4,1490589,1490828,239,+,Verified
YDR526C,YDR526C,4,1491068,1491538,470,-,Dubious
RBA50,YDR527W,4,1491087,1492406,1319,+,Verified
HLR1,YDR528W,4,1494579,1495850,1271,+,Verified
QCR7,YDR529C,4,1496158,1496541,383,-,Verified
APA2,YDR530C,4,1496784,1497761,977,-,Verified
YDR531W,YDR531W,4,1498225,1499328,1103,+,Uncharacterized
YDR532C,YDR532C,4,1499389,1500546,1157,-,Uncharacterized
HSP31,YDR533C,4,1501440,1502153,713,-,Verified
FIT1,YDR534C,4,1503306,1504892,1586,-,Verified
YDR535C,YDR535C,4,1506598,1507354,756,-,Dubious
STL1,YDR536W,4,1507997,1509706,1709,+,Verified
YDR537C,YDR537C,4,1510847,1511452,605,-,Dubious
PAD1,YDR538W,4,1510893,1511621,728,+,Verified
YDR539W,YDR539W,4,1512085,1513596,1511,+,Uncharacterized
IRC4,YDR540C,4,1517121,1517660,539,-,Verified
YDR541C,YDR541C,4,1519649,1520683,1034,-,Uncharacterized
PAU10,YDR542W,4,1523235,1523597,362,+,Uncharacterized
YDR543C,YDR543C,4,1524620,1524919,299,-,Dubious
YDR544C,YDR544C,4,1525081,1525509,428,-,Dubious
YRF1-1,YDR545W,4,1526307,1531697,5390,+,Verified
YDR545C-A,YDR545C-A,4,1530849,1531328,479,-,Dubious
YEL077C,YEL077C,5,264,4097,3833,-,Uncharacterized
YEL077W-A,YEL077W-A,5,630,1112,482,+,Dubious
YEL076C-A,YEL076C-A,5,4185,5114,929,-,Uncharacterized
YEL076C,YEL076C,5,4464,5114,650,-,Uncharacterized
YEL075W-A,YEL075W-A,5,4870,5481,611,+,Dubious
YEL075C,YEL075C,5,5345,5713,368,-,Uncharacterized
YEL074W,YEL074W,5,6126,6464,338,+,Dubious
YEL073C,YEL073C,5,7230,7553,323,-,Uncharacterized
RMD6,YEL072W,5,13720,14415,695,+,Verified
DLD3,YEL071W,5,16355,17845,1490,+,Verified
DSF1,YEL070W,5,19589,21097,1508,+,Uncharacterized
HXT13,YEL069C,5,21537,23231,1694,-,Verified
YEL068C,YEL068C,5,25646,25978,332,-,Dubious
YEL067C,YEL067C,5,26189,26776,587,-,Uncharacterized
HPA3,YEL066W,5,26667,27206,539,+,Verified
SIT1,YEL065W,5,27657,29543,1886,+,Verified
AVT2,YEL064C,5,29797,31239,1442,-,Verified
CAN1,YEL063C,5,31694,33466,1772,-,Verified
NPR2,YEL062W,5,34407,36254,1847,+,Verified
CIN8,YEL061C,5,36535,39537,3002,-,Verified
PRB1,YEL060C,5,40046,41953,1907,-,Verified
SOM1,YEL059C-A,5,42400,42624,224,-,Verified
YEL059W,YEL059W,5,42652,42960,308,+,Dubious
PCM1,YEL058W,5,43252,44925,1673,+,Verified
YEL057C,YEL057C,5,45020,45721,701,-,Uncharacterized
HAT2,YEL056W,5,47168,48373,1205,+,Verified
POL5,YEL055C,5,48471,51539,3068,-,Verified
RPL12A,YEL054C,5,52721,53218,497,-,Verified
YEL053W-A,YEL053W-A,5,52908,53255,347,+,Dubious
MAK10,YEL053C,5,53901,56102,2201,-,Verified
AFG1,YEL052W,5,56571,58100,1529,+,Verified
VMA8,YEL051W,5,58378,59148,770,+,Verified
YEL050W-A,YEL050W-A,5,59549,59740,191,+,Dubious
RML2,YEL050C,5,59670,60851,1181,-,Verified
PAU2,YEL049W,5,63728,64090,362,+,Verified
YEL048C,YEL048C,5,64709,65167,458,-,Uncharacterized
YEL047C,YEL047C,5,65385,66797,1412,-,Verified
GLY1,YEL046C,5,67629,68792,1163,-,Verified
YEL045C,YEL045C,5,68840,69265,425,-,Dubious
IES6,YEL044W,5,69757,70257,500,+,Verified
YEL043W,YEL043W,5,70478,73348,2870,+,Verified
GDA1,YEL042W,5,73771,75327,1556,+,Verified
YEF1,YEL041W,5,75944,77431,1487,+,Verified
UTR2,YEL040W,5,78053,79456,1403,+,Verified
CYC7,YEL039C,5,79636,79977,341,-,Verified
UTR4,YEL038W,5,80462,81145,683,+,Verified
RAD23,YEL037C,5,81407,82603,1196,-,Verified
ANP1,YEL036C,5,83050,84552,1502,-,Verified
UTR5,YEL035C,5,85045,85545,500,-,Uncharacterized
YEL034C-A,YEL034C-A,5,85613,86215,602,-,Dubious
HYP2,YEL034W,5,85676,86149,473,+,Verified
MTC7,YEL033W,5,86179,86598,419,+,Dubious
MCM3,YEL032W,5,86937,89852,2915,+,Verified
YEL032C-A,YEL032C-A,5,87040,87201,161,-,Dubious
SPF1,YEL031W,5,90258,93905,3647,+,Verified
YEL030C-A,YEL030C-A,5,94583,94897,314,-,Dubious
ECM10,YEL030W,5,94644,96578,1934,+,Verified
BUD16,YEL029C,5,96858,97796,938,-,Verified
YEL028W,YEL028W,5,98668,99129,461,+,Dubious
CUP5,YEL027W,5,100769,101251,482,+,Verified
SNU13,YEL026W,5,101943,102323,380,+,Verified
YEL025C,YEL025C,5,102581,106147,3566,-,Uncharacterized
RIP1,YEL024W,5,107260,107907,647,+,Verified
YEL023C,YEL023C,5,108504,110552,2048,-,Uncharacterized
GEA2,YEL022W,5,111421,115800,4379,+,Verified
URA3,YEL021W,5,116167,116970,803,+,Verified
YEL020C-B,YEL020C-B,5,117183,117380,197,-,Dubious
TIM9,YEL020W-A,5,117211,117474,263,+,Verified
YEL020C,YEL020C,5,118617,120299,1682,-,Uncharacterized
MMS21,YEL019C,5,120498,121301,803,-,Verified
YEL018C-A,YEL018C-A,5,121455,121988,533,-,Dubious
EAF5,YEL018W,5,121471,122310,839,+,Verified
PMP2,YEL017C-A,5,122798,122929,131,-,Verified
GTT3,YEL017W,5,123657,124670,1013,+,Verified
NPP2,YEL016C,5,124737,126218,1481,-,Verified
EDC3,YEL015W,5,126629,128284,1655,+,Verified
YEL014C,YEL014C,5,128303,128608,305,-,Dubious
VAC8,YEL013W,5,128825,130561,1736,+,Verified
UBC8,YEL012W,5,131772,132551,779,+,Verified
GLC3,YEL011W,5,133120,135234,2114,+,Verified
YEL010W,YEL010W,5,136279,136629,350,+,Dubious
YEL009C-A,YEL009C-A,5,136371,136778,407,-,Dubious
GCN4,YEL009C,5,138918,139763,845,-,Verified
YEL008W,YEL008W,5,140512,140892,380,+,Dubious
YEL008C-A,YEL008C-A,5,140726,140818,92,-,Dubious
YEL007W,YEL007W,5,141891,143891,2000,+,Uncharacterized
YEA6,YEL006W,5,144326,145333,1007,+,Verified
VAB2,YEL005C,5,145906,146754,848,-,Verified
YEA4,YEL004W,5,146950,147978,1028,+,Verified
GIM4,YEL003W,5,148175,148598,423,+,Verified
WBP1,YEL002C,5,148721,150013,1292,-,Verified
IRC22,YEL001C,5,150300,150977,677,-,Verified
MNN1,YER001W,5,153519,155807,2288,+,Verified
NOP16,YER002W,5,156802,157497,695,+,Verified
PMI40,YER003C,5,157735,159117,1382,-,Verified
FMP52,YER004W,5,159579,160274,695,+,Verified
YND1,YER005W,5,160549,162441,1892,+,Verified
NUG1,YER006W,5,162722,164284,1562,+,Verified
YER006C-A,YER006C-A,5,164343,164660,317,-,Dubious
PAC2,YER007W,5,164526,166082,1556,+,Verified
TMA20,YER007C-A,5,166236,166884,648,-,Verified
SEC3,YER008C,5,167807,171817,4010,-,Verified
NTF2,YER009W,5,172114,172491,377,+,Verified
YER010C,YER010C,5,172633,173337,704,-,Verified
TIR1,YER011W,5,175247,176011,764,+,Verified
PRE1,YER012W,5,177834,178430,596,+,Verified
PRP22,YER013W,5,178840,182277,3437,+,Verified
HEM14,YER014W,5,182599,184218,1619,+,Verified
BUD25,YER014C-A,5,183730,184699,969,-,Verified
FAA2,YER015W,5,184540,186774,2234,+,Verified
BIM1,YER016W,5,188276,189310,1034,+,Verified
AFG3,YER017C,5,189502,191787,2285,-,Verified
SPC25,YER018C,5,191958,192623,665,-,Verified
ISC1,YER019W,5,192796,194229,1433,+,Verified
SBH2,YER019C-A,5,194272,194538,266,-,Verified
GPA2,YER020W,5,195167,196516,1349,+,Verified
RPN3,YER021W,5,196947,198518,1571,+,Verified
SRB4,YER022W,5,198811,200874,2063,+,Verified
PRO3,YER023W,5,201075,201935,860,+,Verified
YER023C-A,YER023C-A,5,201521,201733,212,-,Dubious
YAT2,YER024W,5,202191,204962,2771,+,Verified
GCD11,YER025W,5,205250,206833,1583,+,Verified
CHO1,YER026C,5,207643,208473,830,-,Verified
GAL83,YER027C,5,208978,210231,1253,-,Verified
MIG3,YER028C,5,210691,211875,1184,-,Verified
SMB1,YER029C,5,212586,213176,590,-,Verified
CHZ1,YER030W,5,213436,213897,461,+,Verified
YPT31,YER031C,5,214075,214746,671,-,Verified
FIR1,YER032W,5,215062,217692,2630,+,Verified
ZRG8,YER033C,5,218056,221286,3230,-,Verified
YER034W,YER034W,5,221845,222402,557,+,Uncharacterized
EDC2,YER035W,5,222638,223075,437,+,Verified
ARB1,YER036C,5,223366,225198,1832,-,Verified
PHM8,YER037W,5,225888,226853,965,+,Verified
KRE29,YER038C,5,226857,228251,1394,-,Verified
FMP49,YER038W-A,5,228450,228830,380,+,Dubious
HVG1,YER039C,5,228455,229204,749,-,Verified
YER039C-A,YER039C-A,5,229262,229480,218,-,Uncharacterized
GLN3,YER040W,5,229794,231986,2192,+,Verified
YEN1,YER041W,5,232460,234739,2279,+,Verified
MXR1,YER042W,5,234936,235490,554,+,Verified
SAH1,YER043C,5,235769,237118,1349,-,Verified
ERG28,YER044C,5,237569,238015,446,-,Verified
MEI4,YER044C-A,5,238459,239773,1314,-,Verified
ACA1,YER045C,5,240031,241500,1469,-,Verified
SPO73,YER046W,5,243179,243610,431,+,Verified
YER046W-A,YER046W-A,5,243699,244028,329,+,Dubious
SAP1,YER047C,5,243809,246502,2693,-,Verified
CAJ1,YER048C,5,246981,248156,1175,-,Verified
ISD11,YER048W-A,5,250717,251001,284,+,Verified
TPA1,YER049W,5,251727,253661,1934,+,Verified
RSM18,YER050C,5,253970,254386,416,-,Verified
JHD1,YER051W,5,254655,256133,1478,+,Verified
HOM3,YER052C,5,256374,257957,1583,-,Verified
PIC2,YER053C,5,258736,259638,902,-,Verified
YER053C-A,YER053C-A,5,260932,261045,113,-,Uncharacterized
GIP2,YER054C,5,262051,263697,1646,-,Verified
HIS1,YER055C,5,264891,265784,893,-,Verified
FCY2,YER056C,5,266511,268112,1601,-,Verified
RPL34A,YER056C-A,5,269421,270183,762,-,Verified
HMF1,YER057C,5,270735,271124,389,-,Verified
PET117,YER058W,5,271766,272089,323,+,Verified
PCL6,YER059W,5,272622,273884,1262,+,Verified
FCY21,YER060W,5,274565,276151,1586,+,Verified
FCY22,YER060W-A,5,276570,278162,1592,+,Verified
CEM1,YER061C,5,278296,279624,1328,-,Verified
HOR2,YER062C,5,279928,280680,752,-,Verified
THO1,YER063W,5,281708,282364,656,+,Verified
YER064C,YER064C,5,282703,284220,1517,-,Uncharacterized
ICL1,YER065C,5,285239,286912,1673,-,Verified
YER066W,YER066W,5,290240,290797,557,+,Uncharacterized
YER066C-A,YER066C-A,5,291701,292201,500,-,Dubious
YER067W,YER067W,5,292064,292549,485,+,Uncharacterized
YER067C-A,YER067C-A,5,292238,292561,323,-,Dubious
MOT2,YER068W,5,293048,294811,1763,+,Verified
YER068C-A,YER068C-A,5,295299,295730,431,-,Dubious
ARG5%2C6,YER069W,5,295408,297999,2591,+,Verified
RNR1,YER070W,5,298948,301614,2666,+,Verified
YER071C,YER071C,5,301945,302325,380,-,Uncharacterized
VTC1,YER072W,5,302804,303193,389,+,Verified
ALD5,YER073W,5,304027,305589,1562,+,Verified
RPS24A,YER074W,5,306319,307192,873,+,Verified
YOS1,YER074W-A,5,307649,308119,470,+,Verified
PTP3,YER075C,5,308409,311195,2786,-,Verified
YER076C,YER076C,5,312586,313494,908,-,Uncharacterized
YER076W-A,YER076W-A,5,313386,313733,347,+,Dubious
YER077C,YER077C,5,314530,316596,2066,-,Uncharacterized
ICP55,YER078C,5,316803,318338,1535,-,Uncharacterized
YER078W-A,YER078W-A,5,318642,318806,164,+,Uncharacterized
YER079W,YER079W,5,318916,319548,632,+,Uncharacterized
YER079C-A,YER079C-A,5,319898,320236,338,-,Dubious
AIM9,YER080W,5,319959,321842,1883,+,Uncharacterized
SER3,YER081W,5,322682,324091,1409,+,Verified
UTP7,YER082C,5,324268,325932,1664,-,Verified
GET2,YER083C,5,326170,327027,857,-,Verified
YER084W,YER084W,5,327061,327447,386,+,Dubious
YER084W-A,YER084W-A,5,327594,328106,512,+,Dubious
YER085C,YER085C,5,327615,328136,521,-,Uncharacterized
ILV1,YER086W,5,328473,330203,1730,+,Verified
AIM10,YER087W,5,330572,332302,1730,+,Uncharacterized
YER087C-A,YER087C-A,5,331813,332364,551,-,Dubious
SBH1,YER087C-B,5,332578,332826,248,-,Verified
DOT6,YER088C,5,333172,335184,2012,-,Verified
YER088C-A,YER088C-A,5,335692,336015,323,-,Dubious
YER088W-B,YER088W-B,5,335923,336069,146,+,Dubious
PTC2,YER089C,5,335942,337336,1394,-,Verified
TRP2,YER090W,5,337945,339468,1523,+,Verified
YER090C-A,YER090C-A,5,338318,338407,89,-,Dubious
MET6,YER091C,5,339860,342163,2303,-,Verified
YER091C-A,YER091C-A,5,342386,342607,221,-,Dubious
IES5,YER092W,5,342851,343228,377,+,Verified
TSC11,YER093C,5,343316,347608,4292,-,Verified
AIM11,YER093C-A,5,347908,348396,488,-,Uncharacterized
PUP3,YER094C,5,348725,349342,617,-,Verified
RAD51,YER095W,5,349976,351178,1202,+,Verified
SHC1,YER096W,5,351694,353232,1538,+,Verified
YER097W,YER097W,5,355136,355465,329,+,Dubious
UBP9,YER098W,5,355462,357726,2264,+,Verified
PRS2,YER099C,5,358101,359057,956,-,Verified
UBC6,YER100W,5,359558,360310,752,+,Verified
AST2,YER101C,5,360498,361790,1292,-,Verified
RPS8B,YER102W,5,362729,363698,969,+,Verified
SSA4,YER103W,5,364585,366513,1928,+,Verified
RTT105,YER104W,5,366798,367424,626,+,Verified
NUP157,YER105C,5,367834,372009,4175,-,Verified
MAM1,YER106W,5,372322,373230,908,+,Verified
GLE2,YER107C,5,373444,374541,1097,-,Verified
YER107W-A,YER107W-A,5,374390,374710,320,+,Dubious
FLO8,YER109C,5,375211,377610,2399,-,Verified
KAP123,YER110C,5,378758,382099,3341,-,Verified
SWI4,YER111C,5,382591,385872,3281,-,Verified
LSM4,YER112W,5,387228,387791,563,+,Verified
TMN3,YER113C,5,387928,390048,2120,-,Verified
BOI2,YER114C,5,390586,393708,3122,-,Verified
SPR6,YER115C,5,394288,394863,575,-,Verified
SLX8,YER116C,5,395344,396168,824,-,Verified
RPL23B,YER117W,5,396765,397649,884,+,Verified
SHO1,YER118C,5,397948,399051,1103,-,Verified
AVT6,YER119C,5,399492,400838,1346,-,Verified
YER119C-A,YER119C-A,5,400863,401234,371,-,Dubious
SCS2,YER120W,5,401131,401865,734,+,Verified
YER121W,YER121W,5,402371,402715,344,+,Uncharacterized
GLO3,YER122C,5,402867,404348,1481,-,Verified
YCK3,YER123W,5,404809,406383,1574,+,Verified
DSE1,YER124C,5,407338,409059,1721,-,Verified
RSP5,YER125W,5,410185,412614,2429,+,Verified
NSA2,YER126C,5,413390,414175,785,-,Verified
LCP5,YER127W,5,414477,415550,1073,+,Verified
YER128W,YER128W,5,415855,416466,611,+,Uncharacterized
SAK1,YER129W,5,417277,420705,3428,+,Verified
YER130C,YER130C,5,421111,422442,1331,-,Uncharacterized
RPS26B,YER131W,5,423587,424307,720,+,Verified
PMD1,YER132C,5,425184,430445,5261,-,Verified
GLC7,YER133W,5,432491,433954,1463,+,Verified
YER133W-A,YER133W-A,5,437187,437528,341,+,Dubious
YER134C,YER134C,5,437263,437799,536,-,Uncharacterized
YER135C,YER135C,5,437948,438340,392,-,Dubious
GDI1,YER136W,5,439612,440967,1355,+,Verified
YER137C,YER137C,5,441369,441815,446,-,Uncharacterized
YER137W-A,YER137W-A,5,441571,441876,305,+,Dubious
YER138W-A,YER138W-A,5,449470,449574,104,+,Uncharacterized
RTR1,YER139C,5,450558,451238,680,-,Verified
YER140W,YER140W,5,451560,453230,1670,+,Uncharacterized
COX15,YER141W,5,453454,454914,1460,+,Verified
MAG1,YER142C,5,455141,456031,890,-,Verified
DDI1,YER143W,5,456314,457600,1286,+,Verified
UBP5,YER144C,5,457801,460218,2417,-,Verified
FTR1,YER145C,5,460521,461735,1214,-,Verified
YER145C-A,YER145C-A,5,462381,462818,437,-,Dubious
LSM5,YER146W,5,462580,462861,281,+,Verified
SCC4,YER147C,5,462963,464837,1874,-,Verified
YER147C-A,YER147C-A,5,465198,465608,410,-,Dubious
SPT15,YER148W,5,465298,466020,722,+,Verified
YER148W-A,YER148W-A,5,466180,466758,578,+,Dubious
PEA2,YER149C,5,466203,467465,1262,-,Verified
SPI1,YER150W,5,468365,468811,446,+,Verified
UBP3,YER151C,5,469681,472419,2738,-,Verified
YER152C,YER152C,5,472652,473983,1331,-,Uncharacterized
YER152W-A,YER152W-A,5,473480,474046,566,+,Dubious
PET122,YER153C,5,474036,474800,764,-,Verified
OXA1,YER154W,5,475015,476223,1208,+,Verified
BEM2,YER155C,5,476340,482843,6503,-,Verified
YER156C,YER156C,5,483320,484336,1016,-,Uncharacterized
COG3,YER157W,5,484783,487188,2405,+,Verified
YER158C,YER158C,5,488852,490573,1721,-,Uncharacterized
YER158W-A,YER158W-A,5,491482,491697,215,+,Dubious
BUR6,YER159C,5,491525,491953,428,-,Verified
SPT2,YER161C,5,499342,500343,1001,-,Verified
RAD4,YER162C,5,500625,502889,2264,-,Verified
YER163C,YER163C,5,503079,503777,698,-,Uncharacterized
CHD1,YER164W,5,505387,509793,4406,+,Verified
PAB1,YER165W,5,510368,512101,1733,+,Verified
YER165C-A,YER165C-A,5,512622,512978,356,-,Dubious
DNF1,YER166W,5,512739,517454,4715,+,Verified
BCK2,YER167W,5,518211,520766,2555,+,Verified
CCA1,YER168C,5,521024,522664,1640,-,Verified
RPH1,YER169W,5,523364,525754,2390,+,Verified
ADK2,YER170W,5,525969,526646,677,+,Verified
RAD3,YER171W,5,527077,529413,2336,+,Verified
BRR2,YER172C,5,529525,536016,6491,-,Verified
YER172C-A,YER172C-A,5,536270,536650,380,-,Dubious
RAD24,YER173W,5,536295,538274,1979,+,Verified
GRX4,YER174C,5,538429,539163,734,-,Verified
TMT1,YER175C,5,539459,540358,899,-,Verified
YER175W-A,YER175W-A,5,540645,540809,164,+,Uncharacterized
ECM32,YER176W,5,541685,545050,3365,+,Verified
BMH1,YER177W,5,545606,546409,803,+,Verified
PDA1,YER178W,5,546812,548074,1262,+,Verified
DMC1,YER179W,5,548416,549512,1096,+,Verified
ISC10,YER180C,5,549719,550522,803,-,Verified
SLO1,YER180C-A,5,550860,551117,257,-,Verified
YER181C,YER181C,5,551468,551791,323,-,Dubious
FMP10,YER182W,5,552520,553254,734,+,Uncharacterized
FAU1,YER183C,5,553329,553964,635,-,Verified
YER184C,YER184C,5,556291,558675,2384,-,Uncharacterized
PUG1,YER185W,5,559449,560360,911,+,Verified
YER186C,YER186C,5,561700,562620,920,-,Uncharacterized
YER187W,YER187W,5,566225,566650,425,+,Uncharacterized
YER188W,YER188W,5,568035,568754,719,+,Dubious
YER188C-A,YER188C-A,5,569603,569902,299,-,Uncharacterized
YER189W,YER189W,5,571150,571518,368,+,Uncharacterized
YRF1-2,YER190W,5,571475,576520,5045,+,Verified
YER190C-A,YER190C-A,5,574799,575374,575,-,Dubious
YER190C-B,YER190C-B,5,575675,576157,482,-,Uncharacterized
YFL068W,YFL068W,6,53,535,482,+,Uncharacterized
YFL067W,YFL067W,6,836,1363,527,+,Uncharacterized
YFL066C,YFL066C,6,1437,2615,1178,-,Uncharacterized
YFL065C,YFL065C,6,3030,3338,308,-,Uncharacterized
YFL064C,YFL064C,6,3322,3846,524,-,Uncharacterized
YFL063W,YFL063W,6,5066,5521,455,+,Dubious
COS4,YFL062W,6,6426,7565,1139,+,Verified
DDI2,YFL061W,6,9545,10222,677,+,Uncharacterized
SNO3,YFL060C,6,10301,10969,668,-,Verified
SNZ3,YFL059W,6,11363,12259,896,+,Verified
THI5,YFL058W,6,12929,13951,1022,+,Verified
AAD16,YFL057C,6,14305,14763,458,-,Verified
AAD6,YFL056C,6,14793,15431,638,-,Verified
AGP3,YFL055W,6,17004,18680,1676,+,Verified
YFL054C,YFL054C,6,20847,22787,1940,-,Uncharacterized
DAK2,YFL053W,6,23423,25198,1775,+,Verified
YFL052W,YFL052W,6,28232,29629,1397,+,Uncharacterized
YFL051C,YFL051C,6,30058,30540,482,-,Uncharacterized
ALR2,YFL050C,6,33272,35848,2576,-,Verified
SWP82,YFL049W,6,36803,38674,1871,+,Verified
EMP47,YFL048C,6,38843,40180,1337,-,Verified
RGD2,YFL047W,6,40421,42565,2144,+,Verified
FMP32,YFL046W,6,42815,43438,623,+,Uncharacterized
SEC53,YFL045C,6,43628,44392,764,-,Verified
OTU1,YFL044C,6,44655,45560,905,-,Verified
YFL042C,YFL042C,6,45720,47744,2024,-,Uncharacterized
YFL041W-A,YFL041W-A,6,48734,48925,191,+,Uncharacterized
FET5,YFL041W,6,49139,51007,1868,+,Verified
YFL040W,YFL040W,6,51350,52972,1622,+,Uncharacterized
ACT1,YFL039C,6,53260,54695,1435,-,Verified
YPT1,YFL038C,6,55365,55985,620,-,Verified
TUB2,YFL037W,6,56335,57708,1373,+,Verified
RPO41,YFL036W,6,58781,62836,4055,+,Verified
MOB2,YFL034C-B,6,63015,63992,977,-,Verified
RPL22B,YFL034C-A,6,64242,64931,689,-,Verified
YFL034W,YFL034W,6,65475,68696,3221,+,Uncharacterized
RIM15,YFL033C,6,69113,74425,5312,-,Verified
YFL032W,YFL032W,6,74870,75190,320,+,Dubious
HAC1,YFL031W,6,75177,76145,968,+,Verified
YFL031C-A,YFL031C-A,6,76012,76113,101,-,Dubious
AGX1,YFL030W,6,76829,77986,1157,+,Verified
CAK1,YFL029C,6,78053,79159,1106,-,Verified
CAF16,YFL028C,6,79342,80211,869,-,Verified
GYP8,YFL027C,6,80417,81910,1493,-,Verified
STE2,YFL026W,6,82578,83873,1295,+,Verified
BST1,YFL025C,6,84143,87232,3089,-,Verified
EPL1,YFL024C,6,87845,90343,2498,-,Verified
BUD27,YFL023W,6,90984,93374,2390,+,Verified
FRS2,YFL022C,6,93497,95008,1511,-,Verified
YFL021C-A,YFL021C-A,6,95759,96613,854,-,Dubious
GAT1,YFL021W,6,95964,97496,1532,+,Verified
PAU5,YFL020C,6,99225,99593,368,-,Verified
YFL019C,YFL019C,6,100246,100599,353,-,Dubious
LPD1,YFL018C,6,101622,103121,1499,-,Verified
SMX2,YFL017W-A,6,103693,103926,233,+,Verified
GNA1,YFL017C,6,103977,104456,479,-,Verified
MDJ1,YFL016C,6,104695,106230,1535,-,Verified
YFL015W-A,YFL015W-A,6,106409,106726,317,+,Dubious
YFL015C,YFL015C,6,106463,106957,494,-,Dubious
HSP12,YFL014W,6,107250,107579,329,+,Verified
YFL013W-A,YFL013W-A,6,107793,108596,803,+,Dubious
IES1,YFL013C,6,107846,109924,2078,-,Verified
YFL012W-A,YFL012W-A,6,109804,110178,374,+,Dubious
YFL012W,YFL012W,6,110641,111087,446,+,Uncharacterized
HXT10,YFL011W,6,112339,113979,1640,+,Verified
AUA1,YFL010W-A,6,114984,115268,284,+,Verified
WWM1,YFL010C,6,115102,115737,635,-,Verified
CDC4,YFL009W,6,116139,118478,2339,+,Verified
SMC1,YFL008W,6,119424,123101,3677,+,Verified
BLM10,YFL007W,6,123474,129905,6431,+,Verified
SEC4,YFL005W,6,130329,130976,647,+,Verified
VTC2,YFL004W,6,131805,134291,2486,+,Verified
MSH4,YFL003C,6,134516,137152,2636,-,Verified
SPB4,YFL002C,6,145109,146929,1820,-,Verified
DEG1,YFL001W,6,147126,148454,1328,+,Verified
LOC1,YFR001W,6,149105,149719,614,+,Verified
NIC96,YFR002W,6,150011,152530,2519,+,Verified
YPI1,YFR003C,6,152652,153119,467,-,Verified
RPN11,YFR004W,6,153388,154308,920,+,Verified
SAD1,YFR005C,6,154522,155868,1346,-,Verified
YFR006W,YFR006W,6,156139,157746,1607,+,Uncharacterized
YFH7,YFR007W,6,159293,160354,1061,+,Verified
FAR7,YFR008W,6,160529,161194,665,+,Verified
GCN20,YFR009W,6,162482,164740,2258,+,Verified
YFR009W-A,YFR009W-A,6,163869,164126,257,+,Dubious
UBP6,YFR010W,6,165060,166559,1499,+,Verified
YFR010W-A,YFR010W-A,6,166721,166909,188,+,Dubious
AIM13,YFR011C,6,166739,167251,512,-,Uncharacterized
YFR012W,YFR012W,6,167881,168489,608,+,Uncharacterized
YFR012W-A,YFR012W-A,6,169216,169302,86,+,Uncharacterized
IOC3,YFR013W,6,169914,172277,2363,+,Verified
CMK1,YFR014C,6,172529,173869,1340,-,Verified
GSY1,YFR015C,6,174257,176383,2126,-,Verified
YFR016C,YFR016C,6,177034,180735,3701,-,Verified
YFR017C,YFR017C,6,182262,182849,587,-,Uncharacterized
YFR018C,YFR018C,6,183119,184210,1091,-,Uncharacterized
FAB1,YFR019W,6,184490,191326,6836,+,Verified
YFR020W,YFR020W,6,192726,193424,698,+,Dubious
ATG18,YFR021W,6,194800,196302,1502,+,Verified
ROG3,YFR022W,6,196821,199022,2201,+,Verified
PES4,YFR023W,6,199862,201697,1835,+,Verified
LSB3,YFR024C-A,6,201948,203421,1473,-,Verified
HIS2,YFR025C,6,203731,204738,1007,-,Verified
YFR026C,YFR026C,6,205736,206245,509,-,Uncharacterized
ECO1,YFR027W,6,207440,208285,845,+,Verified
CDC14,YFR028C,6,208401,210056,1655,-,Verified
PTR3,YFR029W,6,210925,212961,2036,+,Verified
MET10,YFR030W,6,213300,216407,3107,+,Verified
SMC2,YFR031C,6,216582,220094,3512,-,Verified
RPL2A,YFR031C-A,6,220495,221406,911,-,Verified
YFR032C,YFR032C,6,222078,222947,869,-,Uncharacterized
RPL29,YFR032C-A,6,223246,223759,513,-,Verified
YFR032C-B,YFR032C-B,6,223698,223961,263,-,Uncharacterized
QCR6,YFR033C,6,224314,224757,443,-,Verified
PHO4,YFR034C,6,225008,225946,938,-,Verified
YFR034W-A,YFR034W-A,6,226010,226297,287,+,Dubious
YFR035C,YFR035C,6,226109,226453,344,-,Uncharacterized
CDC26,YFR036W,6,226950,227324,374,+,Verified
YFR036W-A,YFR036W-A,6,227438,228088,650,+,Dubious
RSC8,YFR037C,6,227500,229173,1673,-,Verified
IRC5,YFR038W,6,229367,231928,2561,+,Verified
YFR039C,YFR039C,6,231999,233531,1532,-,Uncharacterized
SAP155,YFR040W,6,234229,237237,3008,+,Verified
ERJ5,YFR041C,6,237355,238242,887,-,Verified
KEG1,YFR042W,6,238445,239047,602,+,Uncharacterized
IRC6,YFR043C,6,239101,239814,713,-,Verified
DUG1,YFR044C,6,239979,241424,1445,-,Verified
YFR045W,YFR045W,6,241985,242986,1001,+,Uncharacterized
CNN1,YFR046C,6,243061,244146,1085,-,Verified
BNA6,YFR047C,6,244266,245153,887,-,Verified
RMD8,YFR048W,6,246133,248121,1988,+,Verified
YMR31,YFR049W,6,248510,248881,371,+,Verified
PRE4,YFR050C,6,249053,249853,800,-,Verified
RET2,YFR051C,6,250150,251790,1640,-,Verified
RPN12,YFR052W,6,252492,253316,824,+,Verified
YFR052C-A,YFR052C-A,6,253416,253721,305,-,Dubious
HXK1,YFR053C,6,253579,255036,1457,-,Verified
YFR054C,YFR054C,6,258842,259420,578,-,Dubious
YFR056C,YFR056C,6,263944,264312,368,-,Dubious
IRC7,YFR055W,6,264191,265213,1022,+,Uncharacterized
YFR057W,YFR057W,6,269048,269503,455,+,Uncharacterized
COS12,YGL263W,7,2790,3932,1142,+,Verified
YGL262W,YGL262W,7,5312,5839,527,+,Uncharacterized
PAU11,YGL261C,7,6290,6652,362,-,Uncharacterized
YGL260W,YGL260W,7,6860,7090,230,+,Uncharacterized
YPS5,YGL259W,7,8470,8967,497,+,Uncharacterized
YGL258W-A,YGL258W-A,7,9162,9395,233,+,Uncharacterized
VEL1,YGL258W,7,11110,11730,620,+,Verified
MNT2,YGL257C,7,12481,14157,1676,-,Verified
ADH4,YGL256W,7,15159,16307,1148,+,Verified
ZRT1,YGL255W,7,20978,22108,1130,+,Verified
FZF1,YGL254W,7,22304,23203,899,+,Verified
HXK2,YGL253W,7,23935,25395,1460,+,Verified
RTG2,YGL252C,7,25718,27484,1766,-,Verified
HFM1,YGL251C,7,27921,31636,3715,-,Verified
RMR1,YGL250W,7,31910,32635,725,+,Verified
ZIP2,YGL249W,7,33098,35212,2114,+,Verified
PDE1,YGL248W,7,35653,36762,1109,+,Verified
BRR6,YGL247W,7,36933,37526,593,+,Verified
RAI1,YGL246C,7,37617,38780,1163,-,Verified
GUS1,YGL245W,7,39023,41149,2126,+,Verified
RTF1,YGL244W,7,41498,43174,1676,+,Verified
TAD1,YGL243W,7,43307,44509,1202,+,Verified
YGL242C,YGL242C,7,44652,45197,545,-,Uncharacterized
KAP114,YGL241W,7,45445,48459,3014,+,Verified
DOC1,YGL240W,7,48613,49365,752,+,Verified
YGL239C,YGL239C,7,49431,49745,314,-,Dubious
CSE1,YGL238W,7,49552,52434,2882,+,Verified
HAP2,YGL237C,7,52731,53528,797,-,Verified
MTO1,YGL236C,7,53787,55796,2009,-,Verified
YGL235W,YGL235W,7,55279,55815,536,+,Uncharacterized
ADE5%2C7,YGL234W,7,56482,58890,2408,+,Verified
SEC15,YGL233W,7,59122,61854,2732,+,Verified
TAN1,YGL232W,7,62075,63002,927,+,Verified
YGL231C,YGL231C,7,63048,63620,572,-,Uncharacterized
YGL230C,YGL230C,7,63772,64215,443,-,Uncharacterized
SAP4,YGL229C,7,64503,66959,2456,-,Verified
SHE10,YGL228W,7,67598,69331,1733,+,Verified
VID30,YGL227W,7,69671,72547,2876,+,Verified
OST5,YGL226C-A,7,72748,73157,409,-,Verified
MTC3,YGL226W,7,73339,73710,371,+,Uncharacterized
VRG4,YGL225W,7,76893,77906,1013,+,Verified
SDT1,YGL224C,7,78014,78856,842,-,Verified
COG1,YGL223C,7,79111,80364,1253,-,Verified
EDC1,YGL222C,7,80658,81185,527,-,Verified
NIF3,YGL221C,7,81425,82291,866,-,Verified
FRA2,YGL220W,7,82373,82735,362,+,Uncharacterized
MDM34,YGL219C,7,82877,84256,1379,-,Verified
YGL218W,YGL218W,7,83649,84299,650,+,Dubious
YGL217C,YGL217C,7,84838,85179,341,-,Dubious
KIP3,YGL216W,7,84884,87301,2417,+,Verified
CLG1,YGL215W,7,87980,89338,1358,+,Verified
YGL214W,YGL214W,7,90011,90499,488,+,Dubious
SKI8,YGL213C,7,90058,91251,1193,-,Verified
VAM7,YGL212W,7,91436,92386,950,+,Verified
NCS6,YGL211W,7,92516,93595,1079,+,Verified
YPT32,YGL210W,7,93797,94465,668,+,Verified
MIG2,YGL209W,7,95862,97010,1148,+,Verified
SIP2,YGL208W,7,97342,98589,1247,+,Verified
SPT16,YGL207W,7,98973,102080,3107,+,Verified
CHC1,YGL206C,7,102547,107508,4961,-,Verified
POX1,YGL205W,7,108162,110408,2246,+,Verified
YGL204C,YGL204C,7,111704,112009,305,-,Dubious
KEX1,YGL203C,7,112479,114668,2189,-,Verified
ARO8,YGL202W,7,116063,117565,1502,+,Verified
MCM6,YGL201C,7,117858,120911,3053,-,Verified
EMP24,YGL200C,7,122699,123310,611,-,Verified
YGL199C,YGL199C,7,123577,124047,470,-,Dubious
YIP4,YGL198W,7,123596,124303,707,+,Verified
MDS3,YGL197W,7,124703,129166,4463,+,Verified
DSD1,YGL196W,7,129888,131174,1286,+,Verified
GCN1,YGL195W,7,131531,139549,8018,+,Verified
YGL194C-A,YGL194C-A,7,139725,139967,242,-,Uncharacterized
HOS2,YGL194C,7,140374,141732,1358,-,Verified
YGL193C,YGL193C,7,141922,142233,311,-,Uncharacterized
IME4,YGL192W,7,142252,144054,1802,+,Verified
COX13,YGL191W,7,144814,145203,389,+,Verified
CDC55,YGL190C,7,145815,147395,1580,-,Verified
RPS26A,YGL189C,7,148235,148972,737,-,Verified
YGL188C-A,YGL188C-A,7,148830,148970,140,-,Uncharacterized
YGL188C,YGL188C,7,149349,149522,173,-,Dubious
COX4,YGL187C,7,149710,150531,821,-,Verified
TPN1,YGL186C,7,151043,152782,1739,-,Verified
YGL185C,YGL185C,7,153173,154312,1139,-,Uncharacterized
STR3,YGL184C,7,154621,156018,1397,-,Verified
MND1,YGL183C,7,156549,157291,742,-,Verified
YGL182C,YGL182C,7,157279,157602,323,-,Dubious
GTS1,YGL181W,7,157912,159102,1190,+,Verified
ATG1,YGL180W,7,160071,162764,2693,+,Verified
TOS3,YGL179C,7,163415,165097,1682,-,Verified
MPT5,YGL178W,7,167358,170577,3219,+,Verified
YGL177W,YGL177W,7,167565,167912,347,+,Dubious
YGL176C,YGL176C,7,171421,173085,1664,-,Uncharacterized
SAE2,YGL175C,7,173291,174328,1037,-,Verified
BUD13,YGL174W,7,174551,175351,800,+,Verified
KEM1,YGL173C,7,175533,180119,4586,-,Verified
NUP49,YGL172W,7,180706,182124,1418,+,Verified
ROK1,YGL171W,7,182396,184090,1694,+,Verified
SPO74,YGL170C,7,184159,185400,1241,-,Verified
SUA5,YGL169W,7,186065,187345,1280,+,Verified
HUR1,YGL168W,7,187470,187802,332,+,Verified
PMR1,YGL167C,7,187622,190474,2852,-,Verified
CUP2,YGL166W,7,191135,191812,677,+,Verified
YGL165C,YGL165C,7,191404,191982,578,-,Dubious
YRB30,YGL164C,7,191984,193306,1322,-,Verified
RAD54,YGL163C,7,193713,196409,2696,-,Verified
SUT1,YGL162W,7,198144,199043,899,+,Verified
YIP5,YGL161C,7,199216,200148,932,-,Verified
AIM14,YGL160W,7,200567,202279,1712,+,Verified
YGL159W,YGL159W,7,202727,203839,1112,+,Uncharacterized
RCK1,YGL158W,7,207038,208576,1538,+,Verified
YGL157W,YGL157W,7,209011,210054,1043,+,Verified
AMS1,YGL156W,7,210421,213672,3251,+,Verified
CDC43,YGL155W,7,214086,215216,1130,+,Verified
LYS5,YGL154C,7,215283,216101,818,-,Verified
PEX14,YGL153W,7,216278,217303,1025,+,Verified
YGL152C,YGL152C,7,216697,217374,677,-,Dubious
NUT1,YGL151W,7,217529,220927,3398,+,Verified
INO80,YGL150C,7,221109,225578,4469,-,Verified
YGL149W,YGL149W,7,225577,225882,305,+,Dubious
ARO2,YGL148W,7,226404,227534,1130,+,Verified
RPL9A,YGL147C,7,227759,228334,575,-,Verified
YGL146C,YGL146C,7,228756,229691,935,-,Uncharacterized
TIP20,YGL145W,7,230248,232353,2105,+,Verified
ROG1,YGL144C,7,232455,234512,2057,-,Verified
MRF1,YGL143C,7,234722,235963,1241,-,Verified
GPI10,YGL142C,7,236274,238124,1850,-,Verified
HUL5,YGL141W,7,238358,241090,2732,+,Verified
YGL140C,YGL140C,7,241358,245017,3659,-,Uncharacterized
FLC3,YGL139W,7,245721,248129,2408,+,Verified
YGL138C,YGL138C,7,248499,249536,1037,-,Uncharacterized
SEC27,YGL137W,7,249874,252743,2869,+,Verified
MRM2,YGL136C,7,252902,253864,962,-,Verified
RPL1B,YGL135W,7,254646,255299,653,+,Verified
PCL10,YGL134W,7,255668,256969,1301,+,Verified
ITC1,YGL133W,7,257712,261506,3794,+,Verified
YGL132W,YGL132W,7,261585,261920,335,+,Dubious
SNT2,YGL131C,7,261653,265864,4211,-,Verified
CEG1,YGL130W,7,266150,267529,1379,+,Verified
RSM23,YGL129C,7,267728,269194,1466,-,Verified
CWC23,YGL128C,7,269299,270150,851,-,Verified
SOH1,YGL127C,7,270398,270781,383,-,Verified
SCS3,YGL126W,7,271003,272145,1142,+,Verified
MET13,YGL125W,7,272526,274328,1802,+,Verified
MON1,YGL124C,7,274786,276720,1934,-,Verified
RPS2,YGL123W,7,277623,278387,764,+,Verified
YGL123C-A,YGL123C-A,7,277640,277870,230,-,Dubious
NAB2,YGL122C,7,278952,280529,1577,-,Verified
GPG1,YGL121C,7,280783,281163,380,-,Verified
PRP43,YGL120C,7,281640,283943,2303,-,Verified
ABC1,YGL119W,7,284448,285953,1505,+,Verified
YGL118C,YGL118C,7,288020,288457,437,-,Dubious
YGL117W,YGL117W,7,288518,289315,797,+,Uncharacterized
CDC20,YGL116W,7,289812,291644,1832,+,Verified
SNF4,YGL115W,7,292036,293004,968,+,Verified
YGL114W,YGL114W,7,293463,295640,2177,+,Uncharacterized
SLD3,YGL113W,7,295935,297941,2006,+,Verified
TAF6,YGL112C,7,298181,299731,1550,-,Verified
NSA1,YGL111W,7,299981,301372,1391,+,Verified
CUE3,YGL110C,7,301540,303414,1874,-,Verified
YGL109W,YGL109W,7,303516,303839,323,+,Dubious
YGL108C,YGL108C,7,303652,304074,422,-,Uncharacterized
RMD9,YGL107C,7,304336,306276,1940,-,Verified
MLC1,YGL106W,7,306563,307012,449,+,Verified
ARC1,YGL105W,7,307440,308570,1130,+,Verified
VPS73,YGL104C,7,308716,310176,1460,-,Verified
RPL28,YGL103W,7,310970,311930,960,+,Verified
YGL102C,YGL102C,7,311508,311936,428,-,Dubious
YGL101W,YGL101W,7,312196,312843,647,+,Uncharacterized
SEH1,YGL100W,7,313237,314286,1049,+,Verified
LSG1,YGL099W,7,314634,316556,1922,+,Verified
USE1,YGL098W,7,317345,318082,737,+,Verified
SRM1,YGL097W,7,321785,323233,1448,+,Verified
TOS8,YGL096W,7,325334,326164,830,+,Verified
VPS45,YGL095C,7,328877,330610,1733,-,Verified
PAN2,YGL094C,7,331121,334468,3347,-,Verified
SPC105,YGL093W,7,334889,337642,2753,+,Verified
NUP145,YGL092W,7,337909,341862,3953,+,Verified
NBP35,YGL091C,7,342059,343045,986,-,Verified
LIF1,YGL090W,7,343322,344587,1265,+,Verified
MF(ALPHA)2,YGL089C,7,344794,345156,362,-,Verified
YGL088W,YGL088W,7,345839,346204,365,+,Dubious
MMS2,YGL087C,7,346409,346907,498,-,Verified
MAD1,YGL086W,7,347122,349371,2249,+,Verified
YGL085W,YGL085W,7,349619,350443,824,+,Uncharacterized
GUP1,YGL084C,7,350619,352301,1682,-,Verified
SCY1,YGL083W,7,353061,355475,2414,+,Verified
YGL082W,YGL082W,7,355830,356975,1145,+,Uncharacterized
YGL081W,YGL081W,7,357380,358342,962,+,Uncharacterized
FMP37,YGL080W,7,358639,359031,392,+,Uncharacterized
YGL079W,YGL079W,7,359447,360103,656,+,Uncharacterized
DBP3,YGL078C,7,360291,361862,1571,-,Verified
HNM1,YGL077C,7,362228,363919,1691,-,Verified
RPL7A,YGL076C,7,364338,365999,1661,-,Verified
MPS2,YGL075C,7,366928,368091,1163,-,Verified
YGL074C,YGL074C,7,368599,368925,326,-,Dubious
HSF1,YGL073W,7,368756,371257,2501,+,Verified
YGL072C,YGL072C,7,371006,371365,359,-,Dubious
AFT1,YGL071W,7,372015,374087,2072,+,Verified
RPB9,YGL070C,7,374462,374830,368,-,Verified
YGL069C,YGL069C,7,375053,375517,464,-,Dubious
MNP1,YGL068W,7,375090,375674,584,+,Verified
NPY1,YGL067W,7,376104,377258,1154,+,Verified
SGF73,YGL066W,7,377612,379585,1973,+,Verified
ALG2,YGL065C,7,379763,381274,1511,-,Verified
MRH4,YGL064C,7,381526,383211,1685,-,Verified
PUS2,YGL063W,7,383657,384769,1112,+,Verified
YGL063C-A,YGL063C-A,7,384505,384654,149,-,Dubious
PYC1,YGL062W,7,385199,388735,3536,+,Verified
DUO1,YGL061C,7,388971,389714,743,-,Verified
YBP2,YGL060W,7,390070,391995,1925,+,Verified
PKP2,YGL059W,7,392228,393703,1475,+,Verified
RAD6,YGL058W,7,393992,394510,518,+,Verified
YGL057C,YGL057C,7,394972,395835,863,-,Uncharacterized
SDS23,YGL056C,7,396041,397624,1583,-,Verified
OLE1,YGL055W,7,398631,400163,1532,+,Verified
ERV14,YGL054C,7,400874,401290,416,-,Verified
PRM8,YGL053W,7,402592,403305,713,+,Verified
YGL052W,YGL052W,7,403440,403745,305,+,Dubious
MST27,YGL051W,7,403690,404394,704,+,Verified
TYW3,YGL050W,7,405779,406600,821,+,Verified
TIF4632,YGL049C,7,406863,409607,2744,-,Verified
RPT6,YGL048C,7,410072,411289,1217,-,Verified
ALG13,YGL047W,7,411555,412163,608,+,Verified
RIM8,YGL045W,7,414106,415734,1628,+,Verified
RNA15,YGL044C,7,416150,417040,890,-,Verified
DST1,YGL043W,7,417487,418416,929,+,Verified
YGL042C,YGL042C,7,418292,418597,305,-,Dubious
YGL041C-B,YGL041C-B,7,418709,418891,182,-,Uncharacterized
YGL041C,YGL041C,7,418917,419231,314,-,Dubious
YGL041W-A,YGL041W-A,7,419047,419295,248,+,Uncharacterized
HEM2,YGL040C,7,419533,420561,1028,-,Verified
YGL039W,YGL039W,7,423967,425013,1046,+,Verified
OCH1,YGL038C,7,425368,426810,1442,-,Verified
PNC1,YGL037C,7,427303,427953,650,-,Verified
YGL036W,YGL036W,7,428606,431335,2729,+,Uncharacterized
MIG1,YGL035C,7,431553,433067,1514,-,Verified
YGL034C,YGL034C,7,433219,433584,365,-,Dubious
HOP2,YGL033W,7,435630,436356,726,+,Verified
AGA2,YGL032C,7,436575,436838,263,-,Verified
RPL24A,YGL031C,7,437472,438402,930,-,Verified
RPL30,YGL030W,7,439096,439643,547,+,Verified
CGR1,YGL029W,7,440068,440430,362,+,Verified
SCW11,YGL028C,7,441286,442914,1628,-,Verified
CWH41,YGL027C,7,443647,446148,2501,-,Verified
TRP5,YGL026C,7,446417,448540,2123,-,Verified
PGD1,YGL025C,7,448769,449962,1193,-,Verified
YGL024W,YGL024W,7,449793,450128,335,+,Dubious
PIB2,YGL023C,7,450202,452109,1907,-,Verified
STT3,YGL022W,7,452409,454565,2156,+,Verified
ALK1,YGL021W,7,454790,457072,2282,+,Verified
GET1,YGL020C,7,457168,457875,707,-,Verified
CKB1,YGL019W,7,458161,458997,836,+,Verified
JAC1,YGL018C,7,459115,459669,554,-,Verified
ATE1,YGL017W,7,459859,461370,1511,+,Verified
KAP122,YGL016W,7,461671,464916,3245,+,Verified
YGL015C,YGL015C,7,465048,465440,392,-,Uncharacterized
PUF4,YGL014W,7,466146,468812,2666,+,Verified
YGL014C-A,YGL014C-A,7,466242,466403,161,-,Dubious
PDR1,YGL013C,7,469097,472303,3206,-,Verified
ERG4,YGL012W,7,472860,474281,1421,+,Verified
SCL1,YGL011C,7,474494,475252,758,-,Verified
YGL010W,YGL010W,7,475550,476074,524,+,Uncharacterized
LEU1,YGL009C,7,476318,478657,2339,-,Verified
PMA1,YGL008C,7,479915,482671,2756,-,Verified
YGL007C-A,YGL007C-A,7,482946,483032,86,-,Uncharacterized
BRP1,YGL007W,7,483265,483642,377,+,Dubious
YGL006W-A,YGL006W-A,7,485428,485538,110,+,Uncharacterized
PMC1,YGL006W,7,485925,489446,3521,+,Verified
COG7,YGL005C,7,489712,490551,839,-,Verified
RPN14,YGL004C,7,490707,491960,1253,-,Uncharacterized
CDH1,YGL003C,7,492478,494178,1700,-,Verified
ERP6,YGL002W,7,494521,495171,650,+,Verified
ERG26,YGL001C,7,495457,496506,1049,-,Verified
AML1,YGR001C,7,497137,498038,901,-,Uncharacterized
SWC4,YGR002C,7,498480,499910,1430,-,Verified
CUL3,YGR003W,7,500136,502370,2234,+,Verified
PEX31,YGR004W,7,502942,504330,1388,+,Verified
TFG2,YGR005C,7,504661,505863,1202,-,Verified
PRP18,YGR006W,7,506074,506829,755,+,Verified
MUQ1,YGR007W,7,506973,507944,971,+,Verified
STF2,YGR008C,7,508114,508368,254,-,Verified
SEC9,YGR009C,7,509051,511006,1955,-,Verified
NMA2,YGR010W,7,511549,512736,1187,+,Verified
YGR011W,YGR011W,7,512501,512827,326,+,Dubious
YGR012W,YGR012W,7,513163,514344,1181,+,Verified
SNU71,YGR013W,7,514558,516420,1862,+,Verified
MSB2,YGR014W,7,516947,520867,3920,+,Verified
YGR015C,YGR015C,7,521094,522080,986,-,Uncharacterized
YGR016W,YGR016W,7,522265,522837,572,+,Uncharacterized
YGR017W,YGR017W,7,523791,524684,893,+,Uncharacterized
YGR018C,YGR018C,7,524369,524698,329,-,Dubious
UGA1,YGR019W,7,525233,526648,1415,+,Verified
VMA7,YGR020C,7,526977,527333,356,-,Verified
YGR021W,YGR021W,7,527636,528508,872,+,Uncharacterized
YGR022C,YGR022C,7,529261,529590,329,-,Dubious
MTL1,YGR023W,7,529268,530923,1655,+,Verified
THG1,YGR024C,7,531887,532600,713,-,Verified
YGR025W,YGR025W,7,532643,532945,302,+,Dubious
YGR026W,YGR026W,7,532989,533825,836,+,Uncharacterized
RPS25A,YGR027C,7,534136,534789,653,-,Verified
MSP1,YGR028W,7,542207,543295,1088,+,Verified
ERV1,YGR029W,7,543557,544209,652,+,Verified
POP6,YGR030C,7,545685,546161,476,-,Verified
YGR031W,YGR031W,7,546445,547473,1028,+,Uncharacterized
NAG1,YGR031C-A,7,546813,547304,491,-,Verified
GSC2,YGR032W,7,548268,553955,5687,+,Verified
TIM21,YGR033C,7,554252,554971,719,-,Verified
RPL26B,YGR034W,7,555816,556676,860,+,Verified
YGR035C,YGR035C,7,557076,557426,350,-,Uncharacterized
YGR035W-A,YGR035W-A,7,557569,557790,221,+,Uncharacterized
CAX4,YGR036C,7,558153,558872,719,-,Verified
ACB1,YGR037C,7,559735,559998,263,-,Verified
ORM1,YGR038W,7,560686,561354,668,+,Verified
YGR039W,YGR039W,7,574892,575203,311,+,Dubious
KSS1,YGR040W,7,575402,576508,1106,+,Verified
BUD9,YGR041W,7,577491,579134,1643,+,Verified
YGR042W,YGR042W,7,579480,580295,815,+,Uncharacterized
NQM1,YGR043C,7,580439,581440,1001,-,Uncharacterized
RME1,YGR044C,7,582994,583896,902,-,Verified
YGR045C,YGR045C,7,583938,584300,362,-,Dubious
TAM41,YGR046W,7,584899,586056,1157,+,Verified
TFC4,YGR047C,7,586396,589473,3077,-,Verified
UFD1,YGR048W,7,589830,590915,1085,+,Verified
SCM4,YGR049W,7,591318,591881,563,+,Verified
YGR050C,YGR050C,7,592090,592446,356,-,Dubious
YGR051C,YGR051C,7,592910,593233,323,-,Dubious
FMP48,YGR052W,7,593600,594709,1109,+,Uncharacterized
YGR053C,YGR053C,7,594990,595841,851,-,Uncharacterized
YGR054W,YGR054W,7,596697,598625,1928,+,Verified
MUP1,YGR055W,7,599421,601145,1724,+,Verified
RSC1,YGR056W,7,601665,604451,2786,+,Verified
LST7,YGR057C,7,604777,605505,728,-,Verified
PEF1,YGR058W,7,606140,607147,1007,+,Verified
SPR3,YGR059W,7,607567,609105,1538,+,Verified
ERG25,YGR060W,7,610568,611497,929,+,Verified
ADE6,YGR061C,7,611893,615969,4076,-,Verified
COX18,YGR062C,7,616332,617282,950,-,Verified
SPT4,YGR063C,7,617520,617828,308,-,Verified
YGR064W,YGR064W,7,617625,617993,368,+,Dubious
VHT1,YGR065C,7,618081,619862,1781,-,Verified
YGR066C,YGR066C,7,620925,621803,878,-,Uncharacterized
YGR067C,YGR067C,7,622406,624790,2384,-,Uncharacterized
YGR068C,YGR068C,7,625328,627088,1760,-,Uncharacterized
YGR068W-A,YGR068W-A,7,626298,626393,95,+,Dubious
YGR069W,YGR069W,7,627087,627422,335,+,Dubious
ROM1,YGR070W,7,627810,631277,3467,+,Verified
YGR071C,YGR071C,7,631485,634067,2582,-,Uncharacterized
UPF3,YGR072W,7,634308,635471,1163,+,Verified
YGR073C,YGR073C,7,635619,635990,371,-,Dubious
SMD1,YGR074W,7,635716,636156,440,+,Verified
PRP38,YGR075C,7,636151,636879,728,-,Verified
MRPL25,YGR076C,7,637108,637581,473,-,Verified
PEX8,YGR077C,7,637748,639517,1769,-,Verified
PAC10,YGR078C,7,639776,640375,599,-,Verified
YGR079W,YGR079W,7,640724,641836,1112,+,Uncharacterized
TWF1,YGR080W,7,642014,643012,998,+,Verified
SLX9,YGR081C,7,643152,643784,632,-,Verified
TOM20,YGR082W,7,644048,644599,551,+,Verified
GCD2,YGR083C,7,644864,646819,1955,-,Verified
MRP13,YGR084C,7,647127,648146,1019,-,Verified
RPL11B,YGR085C,7,648387,648911,524,-,Verified
PIL1,YGR086C,7,649602,650621,1019,-,Verified
PDC6,YGR087C,7,651294,652985,1691,-,Verified
CTT1,YGR088W,7,654638,656326,1688,+,Verified
NNF2,YGR089W,7,656964,659774,2810,+,Verified
UTP22,YGR090W,7,662362,666075,3713,+,Verified
PRP31,YGR091W,7,666345,667829,1484,+,Verified
DBF2,YGR092W,7,668193,669911,1718,+,Verified
DRN1,YGR093W,7,670392,671915,1523,+,Uncharacterized
VAS1,YGR094W,7,672190,675504,3314,+,Verified
RRP46,YGR095C,7,675675,676346,671,-,Verified
TPC1,YGR096W,7,676625,677569,944,+,Verified
ASK10,YGR097W,7,678699,682139,3440,+,Verified
ESP1,YGR098C,7,682570,687462,4892,-,Verified
TEL2,YGR099W,7,687903,689969,2066,+,Verified
MDR1,YGR100W,7,690249,693101,2852,+,Verified
PCP1,YGR101W,7,693367,694407,1040,+,Verified
YGR102C,YGR102C,7,694588,695139,551,-,Uncharacterized
NOP7,YGR103W,7,695421,697238,1817,+,Verified
SRB5,YGR104C,7,697449,698372,923,-,Verified
VMA21,YGR105W,7,698603,698836,233,+,Verified
VOA1,YGR106C,7,698993,699790,797,-,Uncharacterized
YGR107W,YGR107W,7,702671,703120,449,+,Dubious
CLB1,YGR108W,7,703640,705055,1415,+,Verified
CLB6,YGR109C,7,705363,706505,1142,-,Verified
YGR110W,YGR110W,7,713713,715050,1337,+,Uncharacterized
YGR111W,YGR111W,7,715832,717034,1202,+,Uncharacterized
SHY1,YGR112W,7,717362,718531,1169,+,Verified
DAM1,YGR113W,7,718897,719928,1031,+,Verified
YGR114C,YGR114C,7,720269,720658,389,-,Dubious
YGR115C,YGR115C,7,720376,721155,779,-,Dubious
SPT6,YGR116W,7,720413,724768,4355,+,Verified
YGR117C,YGR117C,7,725053,726483,1430,-,Uncharacterized
RPS23A,YGR118W,7,726978,727735,757,+,Verified
NUP57,YGR119C,7,728051,729676,1625,-,Verified
COG2,YGR120C,7,730038,730826,788,-,Verified
MEP1,YGR121C,7,731454,732932,1478,-,Verified
YGR121W-A,YGR121W-A,7,733417,733632,215,+,Uncharacterized
YGR122W,YGR122W,7,733940,735148,1208,+,Uncharacterized
YGR122C-A,YGR122C-A,7,735635,735763,128,-,Dubious
PPT1,YGR123C,7,736667,738208,1541,-,Verified
ASN2,YGR124W,7,739949,741667,1718,+,Verified
YGR125W,YGR125W,7,742330,745440,3110,+,Uncharacterized
YGR126W,YGR126W,7,745840,746532,692,+,Uncharacterized
YGR127W,YGR127W,7,746803,747741,938,+,Uncharacterized
UTP8,YGR128C,7,747955,750096,2141,-,Verified
SYF2,YGR129W,7,750405,751052,647,+,Verified
YGR130C,YGR130C,7,751399,753849,2450,-,Uncharacterized
YGR131W,YGR131W,7,754731,755255,524,+,Uncharacterized
PHB1,YGR132C,7,755594,756457,863,-,Verified
PEX4,YGR133W,7,756901,757452,551,+,Verified
CAF130,YGR134W,7,757775,761143,3368,+,Verified
PRE9,YGR135W,7,761397,762173,776,+,Verified
LSB1,YGR136W,7,762433,763158,725,+,Verified
YGR137W,YGR137W,7,762893,763267,374,+,Dubious
TPO2,YGR138C,7,763767,765611,1844,-,Verified
YGR139W,YGR139W,7,765731,766069,338,+,Dubious
CBF2,YGR140W,7,767434,770304,2870,+,Verified
VPS62,YGR141W,7,770574,771977,1403,+,Verified
BTN2,YGR142W,7,772459,773691,1232,+,Verified
SKN1,YGR143W,7,775198,777513,2315,+,Verified
THI4,YGR144W,7,780404,781384,980,+,Verified
ENP2,YGR145W,7,781772,783895,2123,+,Verified
YGR146C,YGR146C,7,784228,784863,635,-,Uncharacterized
YGR146C-A,YGR146C-A,7,785281,785442,161,-,Uncharacterized
NAT2,YGR147C,7,786059,786925,866,-,Verified
RPL24B,YGR148C,7,787317,788183,866,-,Verified
YGR149W,YGR149W,7,789036,790334,1298,+,Uncharacterized
DMR1,YGR150C,7,790464,793058,2594,-,Verified
YGR151C,YGR151C,7,794660,794995,335,-,Dubious
RSR1,YGR152C,7,794679,795497,818,-,Verified
YGR153W,YGR153W,7,796097,796750,653,+,Uncharacterized
GTO1,YGR154C,7,796803,797873,1070,-,Verified
CYS4,YGR155W,7,798548,800071,1523,+,Verified
PTI1,YGR156W,7,800551,801828,1277,+,Verified
CHO2,YGR157W,7,802445,805054,2609,+,Verified
MTR3,YGR158C,7,805274,806026,752,-,Verified
NSR1,YGR159C,7,806417,807661,1244,-,Verified
YGR160W,YGR160W,7,807078,807689,611,+,Dubious
RTS3,YGR161C,7,808634,809425,791,-,Uncharacterized
YGR161W-C,YGR161W-C,7,810232,810510,278,+,Uncharacterized
TIF4631,YGR162W,7,824064,826922,2858,+,Verified
GTR2,YGR163W,7,827557,828582,1025,+,Verified
YGR164W,YGR164W,7,828630,828965,335,+,Dubious
MRPS35,YGR165W,7,829121,830158,1037,+,Verified
KRE11,YGR166W,7,830520,832202,1682,+,Verified
CLC1,YGR167W,7,832461,833162,701,+,Verified
YGR168C,YGR168C,7,833357,834487,1130,-,Uncharacterized
PUS6,YGR169C,7,834694,835908,1214,-,Verified
YGR169C-A,YGR169C-A,7,836392,836670,278,-,Uncharacterized
PSD2,YGR170W,7,837147,840563,3416,+,Verified
MSM1,YGR171C,7,840829,842556,1727,-,Verified
YIP1,YGR172C,7,842850,843596,746,-,Verified
RBG2,YGR173W,7,843859,844965,1106,+,Uncharacterized
CBP4,YGR174C,7,845898,846410,512,-,Verified
YGR174W-A,YGR174W-A,7,846660,846746,86,+,Uncharacterized
ERG1,YGR175C,7,846938,848428,1490,-,Verified
YGR176W,YGR176W,7,848725,849072,347,+,Dubious
ATF2,YGR177C,7,848834,850441,1607,-,Verified
PBP1,YGR178C,7,851052,853220,2168,-,Verified
OKP1,YGR179C,7,853680,854900,1220,-,Verified
RNR4,YGR180C,7,855269,856306,1037,-,Verified
TIM13,YGR181W,7,858292,858609,317,+,Verified
YGR182C,YGR182C,7,858556,858909,353,-,Dubious
QCR9,YGR183C,7,859068,859481,413,-,Verified
UBR1,YGR184C,7,859906,865758,5852,-,Verified
TYS1,YGR185C,7,866341,867525,1184,-,Verified
TFG1,YGR186W,7,867779,869986,2207,+,Verified
HGH1,YGR187C,7,870237,871421,1184,-,Verified
BUB1,YGR188C,7,872049,875114,3065,-,Verified
CRH1,YGR189C,7,876674,878197,1523,-,Verified
YGR190C,YGR190C,7,880301,880666,365,-,Dubious
HIP1,YGR191W,7,880425,882236,1811,+,Verified
TDH3,YGR192C,7,882817,883815,998,-,Verified
PDX1,YGR193C,7,884514,885746,1232,-,Verified
XKS1,YGR194C,7,886078,887880,1802,-,Verified
SKI6,YGR195W,7,888887,889627,740,+,Verified
FYV8,YGR196C,7,889738,892191,2453,-,Verified
SNG1,YGR197C,7,892502,894145,1643,-,Verified
YPP1,YGR198W,7,894698,897151,2453,+,Verified
PMT6,YGR199W,7,897507,899786,2279,+,Verified
ELP2,YGR200C,7,899909,902275,2366,-,Verified
YGR201C,YGR201C,7,902525,903202,677,-,Uncharacterized
PCT1,YGR202C,7,903479,904753,1274,-,Verified
YGR203W,YGR203W,7,905242,905688,446,+,Uncharacterized
ADE3,YGR204W,7,905939,908779,2840,+,Verified
YGR204C-A,YGR204C-A,7,909066,909179,113,-,Uncharacterized
YGR205W,YGR205W,7,909218,910090,872,+,Verified
MVB12,YGR206W,7,910437,910742,305,+,Verified
YGR207C,YGR207C,7,910848,911633,785,-,Verified
SER2,YGR208W,7,911888,912817,929,+,Verified
TRX2,YGR209C,7,912918,913232,314,-,Verified
YGR210C,YGR210C,7,913508,914743,1235,-,Uncharacterized
ZPR1,YGR211W,7,915246,916706,1460,+,Verified
SLI1,YGR212W,7,917045,918451,1406,+,Verified
RTA1,YGR213C,7,918517,919470,953,-,Verified
RPS0A,YGR214W,7,920580,921793,1213,+,Verified
RSM27,YGR215W,7,922180,922512,332,+,Verified
GPI1,YGR216C,7,922638,924467,1829,-,Verified
CCH1,YGR217W,7,924699,930818,6119,+,Verified
CRM1,YGR218W,7,932544,935798,3254,+,Verified
YGR219W,YGR219W,7,936038,936379,341,+,Dubious
MRPL9,YGR220C,7,936077,936886,809,-,Verified
TOS2,YGR221C,7,937127,938995,1868,-,Verified
PET54,YGR222W,7,939926,940807,881,+,Verified
HSV2,YGR223C,7,940872,942218,1346,-,Verified
AZR1,YGR224W,7,942809,944650,1841,+,Verified
AMA1,YGR225W,7,945148,947022,1874,+,Verified
YGR226C,YGR226C,7,946795,947004,209,-,Dubious
DIE2,YGR227W,7,947423,949000,1577,+,Verified
YGR228W,YGR228W,7,949368,949712,344,+,Dubious
SMI1,YGR229C,7,949385,950902,1517,-,Verified
BNS1,YGR230W,7,951897,952310,413,+,Verified
PHB2,YGR231C,7,952551,953483,932,-,Verified
NAS6,YGR232W,7,953963,954649,686,+,Verified
PHO81,YGR233C,7,954677,958213,3536,-,Verified
YHB1,YGR234W,7,959908,961107,1199,+,Verified
YGR235C,YGR235C,7,961364,962065,701,-,Uncharacterized
SPG1,YGR236C,7,962534,962821,287,-,Verified
YGR237C,YGR237C,7,963303,965660,2357,-,Uncharacterized
KEL2,YGR238C,7,966044,968692,2648,-,Verified
PEX21,YGR239C,7,969192,970058,866,-,Verified
PFK1,YGR240C,7,970776,973739,2963,-,Verified
YGR240C-A,YGR240C-A,7,974582,974782,200,-,Uncharacterized
YAP1802,YGR241C,7,974880,976586,1706,-,Verified
YGR242W,YGR242W,7,976420,976728,308,+,Dubious
FMP43,YGR243W,7,977341,977781,440,+,Uncharacterized
LSC2,YGR244C,7,978041,979324,1283,-,Verified
SDA1,YGR245C,7,979770,982073,2303,-,Verified
BRF1,YGR246C,7,982487,984277,1790,-,Verified
CPD1,YGR247W,7,984971,985690,719,+,Verified
SOL4,YGR248W,7,985977,986744,767,+,Verified
MGA1,YGR249W,7,988054,989424,1370,+,Verified
YGR250C,YGR250C,7,991181,993526,2345,-,Uncharacterized
YGR251W,YGR251W,7,995644,996234,590,+,Uncharacterized
GCN5,YGR252W,7,996874,998193,1319,+,Verified
PUP2,YGR253C,7,998363,999145,782,-,Verified
ENO1,YGR254W,7,1000932,1002245,1313,+,Verified
COQ6,YGR255C,7,1002528,1003967,1439,-,Verified
GND2,YGR256W,7,1004630,1006108,1478,+,Verified
MTM1,YGR257C,7,1006211,1007311,1100,-,Verified
RAD2,YGR258C,7,1007677,1010772,3095,-,Verified
YGR259C,YGR259C,7,1012487,1012927,440,-,Dubious
TNA1,YGR260W,7,1012491,1014095,1604,+,Verified
APL6,YGR261C,7,1014327,1016756,2429,-,Verified
BUD32,YGR262C,7,1016980,1017765,785,-,Verified
SAY1,YGR263C,7,1017973,1019247,1274,-,Verified
MES1,YGR264C,7,1019604,1021859,2255,-,Verified
YGR265W,YGR265W,7,1021654,1022064,410,+,Dubious
YGR266W,YGR266W,7,1022662,1024767,2105,+,Verified
FOL2,YGR267C,7,1025010,1025741,731,-,Verified
HUA1,YGR268C,7,1026063,1026659,596,-,Verified
YGR269W,YGR269W,7,1026642,1026968,326,+,Dubious
YTA7,YGR270W,7,1027376,1031515,4139,+,Verified
YGR270C-A,YGR270C-A,7,1027388,1027606,218,-,Dubious
SLH1,YGR271W,7,1031797,1037700,5903,+,Verified
EFG1,YGR271C-A,7,1037806,1038507,701,-,Verified
YGR273C,YGR273C,7,1038721,1039245,524,-,Uncharacterized
TAF1,YGR274C,7,1039902,1043102,3200,-,Verified
RTT102,YGR275W,7,1043283,1043756,473,+,Verified
RNH70,YGR276C,7,1043826,1045487,1661,-,Verified
YGR277C,YGR277C,7,1045651,1046568,917,-,Uncharacterized
CWC22,YGR278W,7,1046738,1048471,1733,+,Verified
SCW4,YGR279C,7,1048805,1049965,1160,-,Verified
PXR1,YGR280C,7,1050917,1051732,815,-,Verified
YOR1,YGR281W,7,1052831,1057264,4433,+,Verified
BGL2,YGR282C,7,1057790,1058731,941,-,Verified
YGR283C,YGR283C,7,1059022,1060047,1025,-,Verified
ERV29,YGR284C,7,1060665,1061597,932,-,Verified
ZUO1,YGR285C,7,1061859,1063160,1301,-,Verified
BIO2,YGR286C,7,1063820,1064947,1127,-,Verified
YGR287C,YGR287C,7,1067229,1068998,1769,-,Verified
MAL13,YGR288W,7,1070300,1071721,1421,+,Verified
MAL11,YGR289C,7,1073970,1075820,1850,-,Verified
YGR290W,YGR290W,7,1075489,1075932,443,+,Dubious
YGR291C,YGR291C,7,1076290,1076511,221,-,Dubious
MAL12,YGR292W,7,1076606,1078360,1754,+,Verified
YGR293C,YGR293C,7,1079892,1080353,461,-,Dubious
PAU12,YGR294W,7,1080313,1080675,362,+,Uncharacterized
COS6,YGR295C,7,1081591,1082736,1145,-,Verified
YRF1-3,YGR296W,7,1084871,1090598,5727,+,Verified
YGR296C-A,YGR296C-A,7,1088877,1089452,575,-,Dubious
YGR296C-B,YGR296C-B,7,1089753,1090235,482,-,Dubious
YHL050C,YHL050C,8,445,3310,2865,-,Uncharacterized
YHL050W-A,YHL050W-A,8,811,1293,482,+,Dubious
YHL049C,YHL049C,8,3725,4540,815,-,Uncharacterized
YHL048C-A,YHL048C-A,8,5662,5796,134,-,Uncharacterized
COS8,YHL048W,8,6400,7545,1145,+,Verified
ARN2,YHL047C,8,8298,10211,1913,-,Verified
YHL046W-A,YHL046W-A,8,9979,10305,326,+,Dubious
PAU13,YHL046C,8,11921,12283,362,-,Uncharacterized
YHL045W,YHL045W,8,12500,12847,347,+,Dubious
YHL044W,YHL044W,8,13563,14270,707,+,Uncharacterized
ECM34,YHL043W,8,14899,15411,512,+,Verified
YHL042W,YHL042W,8,15665,16117,452,+,Uncharacterized
YHL041W,YHL041W,8,17390,17839,449,+,Dubious
ARN1,YHL040C,8,19085,20968,1883,-,Verified
YHL039W,YHL039W,8,21780,23537,1757,+,Uncharacterized
CBP2,YHL038C,8,23614,25506,1892,-,Verified
YHL037C,YHL037C,8,25698,26177,479,-,Dubious
MUP3,YHL036W,8,26239,27879,1640,+,Verified
VMR1,YHL035C,8,27976,32754,4778,-,Verified
YHL034W-A,YHL034W-A,8,33174,33635,461,+,Dubious
SBP1,YHL034C,8,33191,34075,884,-,Verified
RPL8A,YHL033C,8,35253,36023,770,-,Verified
GUT1,YHL032C,8,36377,38506,2129,-,Verified
GOS1,YHL031C,8,38813,39484,671,-,Verified
YHL030W-A,YHL030W-A,8,39072,39533,461,+,Dubious
ECM29,YHL030W,8,40082,45688,5606,+,Verified
OCA5,YHL029C,8,45927,47966,2039,-,Uncharacterized
WSC4,YHL028W,8,48761,50578,1817,+,Verified
RIM101,YHL027W,8,51109,52986,1877,+,Verified
YHL026C,YHL026C,8,53217,54164,947,-,Uncharacterized
SNF6,YHL025W,8,54849,55847,998,+,Verified
RIM4,YHL024W,8,56647,58788,2141,+,Verified
RMD11,YHL023C,8,59121,62561,3440,-,Verified
SPO11,YHL022C,8,62959,64155,1196,-,Verified
AIM17,YHL021C,8,64459,65856,1397,-,Uncharacterized
OPI1,YHL020C,8,66239,67453,1214,-,Verified
YHL019W-A,YHL019W-A,8,67708,68301,593,+,Dubious
APM2,YHL019C,8,67728,69545,1817,-,Verified
YHL018W,YHL018W,8,69705,70067,362,+,Uncharacterized
YHL017W,YHL017W,8,70273,71871,1598,+,Uncharacterized
DUR3,YHL016C,8,72034,74241,2207,-,Verified
YHL015W-A,YHL015W-A,8,74696,74779,83,+,Uncharacterized
RPS20,YHL015W,8,75409,75774,365,+,Verified
YLF2,YHL014C,8,76094,77311,1217,-,Verified
OTU2,YHL013C,8,77427,78350,923,-,Verified
YHL012W,YHL012W,8,78932,80413,1481,+,Uncharacterized
PRS3,YHL011C,8,80650,81612,962,-,Verified
BRP2,YHL010C,8,81960,83717,1757,-,Uncharacterized
YAP3,YHL009C,8,84064,85056,992,-,Verified
YHL008C,YHL008C,8,92623,94506,1883,-,Uncharacterized
STE20,YHL007C,8,95114,97933,2819,-,Verified
YHL006W-A,YHL006W-A,8,97728,98081,353,+,Dubious
SHU1,YHL006C,8,98339,98791,452,-,Verified
YHL005C,YHL005C,8,98824,99216,392,-,Dubious
MRP4,YHL004W,8,99215,100399,1184,+,Verified
LAG1,YHL003C,8,100644,101879,1235,-,Verified
YHL002C-A,YHL002C-A,8,102582,103070,488,-,Dubious
HSE1,YHL002W,8,102607,103965,1358,+,Verified
RPL14B,YHL001W,8,104272,105086,814,+,Verified
OSH7,YHR001W,8,106050,107363,1313,+,Verified
QCR10,YHR001W-A,8,107821,108117,296,+,Verified
LEU5,YHR002W,8,108807,109880,1073,+,Verified
YHR003C,YHR003C,8,110023,111312,1289,-,Verified
NEM1,YHR004C,8,111749,113089,1340,-,Verified
GPA1,YHR005C,8,113494,114912,1418,-,Verified
MRS11,YHR005C-A,8,115615,115896,281,-,Verified
STP2,YHR006W,8,117809,119434,1625,+,Verified
ERG11,YHR007C,8,120086,121678,1592,-,Verified
YHR007C-A,YHR007C-A,8,122545,122760,215,-,Uncharacterized
SOD2,YHR008C,8,122884,123585,701,-,Verified
YHR009C,YHR009C,8,124104,125675,1571,-,Uncharacterized
RPL27A,YHR010W,8,126515,127486,971,+,Verified
DIA4,YHR011W,8,127774,129114,1340,+,Verified
VPS29,YHR012W,8,129475,130442,967,+,Verified
ARD1,YHR013C,8,130724,131440,716,-,Verified
SPO13,YHR014W,8,132040,132915,875,+,Verified
MIP6,YHR015W,8,134547,136526,1979,+,Verified
YSC84,YHR016C,8,136874,138448,1574,-,Verified
YSC83,YHR017W,8,138687,139844,1157,+,Verified
ARG4,YHR018C,8,140004,141395,1391,-,Verified
DED81,YHR019C,8,141887,143551,1664,-,Verified
YHR020W,YHR020W,8,143989,146055,2066,+,Verified
RPS27B,YHR021C,8,147864,148662,798,-,Verified
ECM12,YHR021W-A,8,149218,149673,455,+,Uncharacterized
YHR022C,YHR022C,8,149568,150338,770,-,Uncharacterized
YHR022C-A,YHR022C-A,8,151210,151299,89,-,Uncharacterized
MYO1,YHR023W,8,151659,157445,5786,+,Verified
MAS2,YHR024C,8,157737,159185,1448,-,Verified
THR1,YHR025W,8,159431,160504,1073,+,Verified
PPA1,YHR026W,8,160837,161478,641,+,Verified
RPN1,YHR027C,8,161723,164704,2981,-,Verified
DAP2,YHR028C,8,164971,167427,2456,-,Verified
YHR028W-A,YHR028W-A,8,167345,167665,320,+,Dubious
YHI9,YHR029C,8,167670,168554,884,-,Verified
SLT2,YHR030C,8,168883,170337,1454,-,Verified
RRM3,YHR031C,8,170792,172963,2171,-,Verified
YHR032W,YHR032W,8,173337,175082,1745,+,Uncharacterized
YHR032W-A,YHR032W-A,8,175188,175367,179,+,Dubious
YHR032C-A,YHR032C-A,8,175268,175387,119,-,Dubious
YHR033W,YHR033W,8,175541,176812,1271,+,Uncharacterized
PIH1,YHR034C,8,176958,177992,1034,-,Verified
YHR035W,YHR035W,8,178212,180104,1892,+,Uncharacterized
BRL1,YHR036W,8,180338,181753,1415,+,Verified
PUT2,YHR037W,8,181970,183697,1727,+,Verified
RRF1,YHR038W,8,184059,184751,692,+,Verified
MSC7,YHR039C,8,184868,186802,1934,-,Verified
VMA10,YHR039C-A,8,187166,187672,506,-,Verified
BCD1,YHR040W,8,187917,189017,1100,+,Verified
SRB2,YHR041C,8,189124,189857,733,-,Verified
NCP1,YHR042W,8,190536,192611,2075,+,Verified
DOG2,YHR043C,8,192798,193538,740,-,Verified
DOG1,YHR044C,8,194061,194801,740,-,Verified
YHR045W,YHR045W,8,195544,197226,1682,+,Uncharacterized
INM1,YHR046C,8,197391,198278,887,-,Verified
AAP1,YHR047C,8,198733,201303,2570,-,Verified
YHK8,YHR048W,8,204600,206144,1544,+,Uncharacterized
FSH1,YHR049W,8,206455,207186,731,+,Verified
YHR049C-A,YHR049C-A,8,207213,207524,311,-,Dubious
SMF2,YHR050W,8,207648,209297,1649,+,Verified
YHR050W-A,YHR050W-A,8,209469,209639,170,+,Uncharacterized
COX6,YHR051W,8,209699,210145,446,+,Verified
CIC1,YHR052W,8,210842,211972,1130,+,Verified
YHR052W-A,YHR052W-A,8,212512,212706,194,+,Dubious
CUP1-1,YHR053C,8,212537,212722,185,-,Verified
YHR054C,YHR054C,8,213187,214251,1064,-,Uncharacterized
YHR054W-A,YHR054W-A,8,214510,214704,194,+,Dubious
CUP1-2,YHR055C,8,214535,214720,185,-,Verified
RSC30,YHR056C,8,215185,217836,2651,-,Verified
YHR056W-A,YHR056W-A,8,217408,217842,434,+,Dubious
CPR2,YHR057C,8,218228,218845,617,-,Verified
MED6,YHR058C,8,218999,219886,887,-,Verified
FYV4,YHR059W,8,220110,220502,392,+,Verified
VMA22,YHR060W,8,220727,221272,545,+,Verified
GIC1,YHR061C,8,221536,222480,944,-,Verified
RPP1,YHR062C,8,222879,223760,881,-,Verified
PAN5,YHR063C,8,224032,225171,1139,-,Verified
YHR063W-A,YHR063W-A,8,225444,225779,335,+,Dubious
SSZ1,YHR064C,8,225527,227143,1616,-,Verified
RRP3,YHR065C,8,227534,229039,1505,-,Verified
SSF1,YHR066W,8,229337,230698,1361,+,Verified
HTD2,YHR067W,8,230972,231814,842,+,Verified
DYS1,YHR068W,8,232135,233298,1163,+,Verified
RRP4,YHR069C,8,233581,234660,1079,-,Verified
YHR069C-A,YHR069C-A,8,234876,235238,362,-,Dubious
TRM5,YHR070W,8,234883,236382,1499,+,Verified
YHR070C-A,YHR070C-A,8,236104,236514,410,-,Dubious
PCL5,YHR071W,8,237006,237695,689,+,Verified
YHR071C-A,YHR071C-A,8,238912,239232,320,-,Dubious
ERG7,YHR072W,8,239100,241295,2195,+,Verified
NOP10,YHR072W-A,8,241666,241842,176,+,Verified
OSH3,YHR073W,8,242584,245574,2990,+,Verified
YHR073W-A,YHR073W-A,8,242870,243046,176,+,Dubious
YHR073C-B,YHR073C-B,8,245424,245504,80,-,Dubious
QNS1,YHR074W,8,246195,248339,2144,+,Verified
PPE1,YHR075C,8,248441,249643,1202,-,Verified
PTC7,YHR076W,8,251103,252227,1124,+,Verified
NMD2,YHR077C,8,252376,255758,3382,-,Verified
YHR078W,YHR078W,8,256362,258020,1658,+,Uncharacterized
IRE1,YHR079C,8,258246,261593,3347,-,Verified
SAE3,YHR079C-A,8,262194,262555,361,-,Verified
YHR080C,YHR080C,8,262803,266840,4037,-,Verified
LRP1,YHR081W,8,267540,268094,554,+,Verified
KSP1,YHR082C,8,268461,271550,3089,-,Verified
SAM35,YHR083W,8,272629,273618,989,+,Verified
STE12,YHR084W,8,274176,276242,2066,+,Verified
IPI1,YHR085W,8,276766,277770,1004,+,Verified
NAM8,YHR086W,8,278155,279726,1571,+,Verified
YHR086W-A,YHR086W-A,8,280233,280394,161,+,Uncharacterized
RTC3,YHR087W,8,280822,281157,335,+,Verified
RPF1,YHR088W,8,281497,282384,887,+,Verified
GAR1,YHR089C,8,282683,283300,617,-,Verified
YNG2,YHR090C,8,283779,284627,848,-,Verified
MSR1,YHR091C,8,284841,286772,1931,-,Verified
HXT4,YHR092C,8,287132,288814,1682,-,Verified
AHT1,YHR093W,8,289145,289693,548,+,Dubious
HXT1,YHR094C,8,290916,292628,1712,-,Verified
YHR095W,YHR095W,8,292946,293380,434,+,Dubious
HXT5,YHR096C,8,294672,296450,1778,-,Verified
YHR097C,YHR097C,8,297388,298612,1224,-,Uncharacterized
SFB3,YHR098C,8,299148,301937,2789,-,Verified
TRA1,YHR099W,8,302764,313998,11234,+,Verified
YHR100C,YHR100C,8,314119,314676,557,-,Uncharacterized
BIG1,YHR101C,8,314877,315971,1094,-,Verified
KIC1,YHR102W,8,316575,319817,3242,+,Verified
SBE22,YHR103W,8,320417,322975,2558,+,Verified
GRE3,YHR104W,8,323412,324395,983,+,Verified
YPT35,YHR105W,8,324769,325413,644,+,Verified
TRR2,YHR106W,8,325601,326629,1028,+,Verified
CDC12,YHR107C,8,326816,328039,1223,-,Verified
GGA2,YHR108W,8,328306,330063,1757,+,Verified
CTM1,YHR109W,8,330313,332070,1757,+,Verified
ERP5,YHR110W,8,332285,332923,638,+,Verified
UBA4,YHR111W,8,333075,334397,1322,+,Verified
YHR112C,YHR112C,8,334530,335666,1136,-,Uncharacterized
YHR113W,YHR113W,8,336340,337812,1472,+,Verified
BZZ1,YHR114W,8,338086,339987,1901,+,Verified
DMA1,YHR115C,8,340112,341362,1250,-,Verified
COX23,YHR116W,8,341668,342123,455,+,Verified
TOM71,YHR117W,8,342352,344271,1919,+,Verified
ORC6,YHR118C,8,344324,345631,1307,-,Verified
SET1,YHR119W,8,346046,349288,3242,+,Verified
MSH1,YHR120W,8,349577,352456,2879,+,Verified
LSM12,YHR121W,8,352759,353322,563,+,Verified
YHR122W,YHR122W,8,353628,354323,695,+,Verified
EPT1,YHR123W,8,354818,356084,1266,+,Verified
NDT80,YHR124W,8,356564,358447,1883,+,Verified
YHR125W,YHR125W,8,358861,359166,305,+,Dubious
YHR126C,YHR126C,8,359705,360184,479,-,Uncharacterized
YHR127W,YHR127W,8,360916,361647,731,+,Verified
FUR1,YHR128W,8,362118,362768,650,+,Verified
ARP1,YHR129C,8,363002,364156,1154,-,Verified
YHR130C,YHR130C,8,364968,365303,335,-,Dubious
YHR131C,YHR131C,8,365343,367895,2552,-,Uncharacterized
YHR131W-A,YHR131W-A,8,367750,367995,245,+,Dubious
ECM14,YHR132C,8,368505,369797,1292,-,Verified
IGO2,YHR132W-A,8,370057,370452,395,+,Uncharacterized
NSG1,YHR133C,8,370725,371600,875,-,Verified
WSS1,YHR134W,8,371752,372561,809,+,Verified
YCK1,YHR135C,8,372697,374313,1616,-,Verified
SPL2,YHR136C,8,374657,375103,446,-,Verified
ARO9,YHR137W,8,375712,377253,1541,+,Verified
YHR137C-A,YHR137C-A,8,375741,376391,650,-,Dubious
YHR138C,YHR138C,8,377358,377702,344,-,Uncharacterized
SPS100,YHR139C,8,378222,379202,980,-,Verified
YHR139C-A,YHR139C-A,8,380111,380422,311,-,Dubious
YHR140W,YHR140W,8,380575,381294,719,+,Uncharacterized
RPL42B,YHR141C,8,381993,382754,761,-,Verified
CHS7,YHR142W,8,383541,384491,950,+,Verified
DSE2,YHR143W,8,385513,386490,977,+,Verified
RPC10,YHR143W-A,8,387236,387448,212,+,Verified
DCD1,YHR144C,8,387791,388729,938,-,Verified
YHR145C,YHR145C,8,388984,389340,356,-,Dubious
CRP1,YHR146W,8,390303,391700,1397,+,Verified
MRPL6,YHR147C,8,392642,393286,644,-,Verified
IMP3,YHR148W,8,393537,394088,551,+,Verified
SKG6,YHR149C,8,394458,396662,2204,-,Verified
PEX28,YHR150W,8,397254,398993,1739,+,Verified
MTC6,YHR151C,8,399271,400851,1580,-,Uncharacterized
SPO12,YHR152W,8,401437,401958,521,+,Verified
SPO16,YHR153C,8,402089,402685,596,-,Verified
RTT107,YHR154W,8,402969,406181,3212,+,Verified
YSP1,YHR155W,8,407106,410792,3686,+,Verified
LIN1,YHR156C,8,411387,412409,1022,-,Verified
REC104,YHR157W,8,412910,413458,548,+,Verified
KEL1,YHR158C,8,413688,417182,3494,-,Verified
YHR159W,YHR159W,8,417552,419066,1514,+,Uncharacterized
PEX18,YHR160C,8,419224,420075,851,-,Verified
YAP1801,YHR161C,8,420376,422289,1913,-,Verified
YHR162W,YHR162W,8,423075,423464,389,+,Uncharacterized
SOL3,YHR163W,8,423726,424475,749,+,Verified
DNA2,YHR164C,8,424612,429180,4568,-,Verified
PRP8,YHR165C,8,429709,436950,7241,-,Verified
YHR165W-A,YHR165W-A,8,436649,436960,311,+,Dubious
CDC23,YHR166C,8,437172,439052,1880,-,Verified
THP2,YHR167W,8,439344,440129,785,+,Verified
MTG2,YHR168W,8,440379,441878,1499,+,Verified
DBP8,YHR169W,8,442182,443477,1295,+,Verified
NMD3,YHR170W,8,443829,445385,1556,+,Verified
ATG7,YHR171W,8,445713,447605,1892,+,Verified
SPC97,YHR172W,8,448335,450806,2471,+,Verified
YHR173C,YHR173C,8,450815,451153,338,-,Dubious
ENO2,YHR174W,8,451327,452640,1313,+,Verified
CTR2,YHR175W,8,452872,453441,569,+,Verified
YHR175W-A,YHR175W-A,8,453558,453707,149,+,Uncharacterized
FMO1,YHR176W,8,454229,455527,1298,+,Verified
YHR177W,YHR177W,8,456591,457952,1361,+,Uncharacterized
STB5,YHR178W,8,459299,461530,2231,+,Verified
OYE2,YHR179W,8,462502,463704,1202,+,Verified
YHR180W,YHR180W,8,465178,465669,491,+,Dubious
YHR180W-A,YHR180W-A,8,466932,467114,182,+,Dubious
YHR180C-B,YHR180C-B,8,466958,467062,104,-,Dubious
SVP26,YHR181W,8,467228,467914,686,+,Verified
YHR182W,YHR182W,8,468219,470576,2357,+,Uncharacterized
YHR182C-A,YHR182C-A,8,470939,471412,473,-,Dubious
GND1,YHR183W,8,470960,472429,1469,+,Verified
SSP1,YHR184W,8,472744,474459,1715,+,Verified
PFS1,YHR185C,8,474627,475340,713,-,Verified
KOG1,YHR186C,8,475999,480672,4673,-,Verified
IKI1,YHR187W,8,480990,481919,929,+,Verified
GPI16,YHR188C,8,482005,483837,1832,-,Verified
PTH1,YHR189W,8,484028,484600,572,+,Verified
ERG9,YHR190W,8,484845,486179,1334,+,Verified
CTF8,YHR191C,8,486230,486631,401,-,Verified
YHR192W,YHR192W,8,486826,487662,836,+,Uncharacterized
EGD2,YHR193C,8,487712,488236,524,-,Verified
YHR193C-A,YHR193C-A,8,488653,489027,374,-,Dubious
MDM31,YHR194W,8,488657,490396,1739,+,Verified
NVJ1,YHR195W,8,490747,491712,965,+,Verified
UTP9,YHR196W,8,491931,493658,1727,+,Verified
RIX1,YHR197W,8,493896,496187,2291,+,Verified
AIM18,YHR198C,8,496315,497280,965,-,Uncharacterized
AIM46,YHR199C,8,497490,498422,932,-,Uncharacterized
YHR199C-A,YHR199C-A,8,498571,498859,288,-,Uncharacterized
RPN10,YHR200W,8,499079,499885,806,+,Verified
PPX1,YHR201C,8,499950,501143,1193,-,Verified
YHR202W,YHR202W,8,502388,504196,1808,+,Uncharacterized
RPS4B,YHR203C,8,504476,505530,1054,-,Verified
MNL1,YHR204W,8,506319,508709,2390,+,Verified
SCH9,YHR205W,8,509363,511837,2474,+,Verified
SKN7,YHR206W,8,512732,514600,1868,+,Verified
SET5,YHR207C,8,514905,516485,1580,-,Verified
BAT1,YHR208W,8,517532,518713,1181,+,Verified
CRG1,YHR209W,8,519437,520312,875,+,Uncharacterized
YHR210C,YHR210C,8,520712,521737,1025,-,Uncharacterized
FLO5,YHR211W,8,525392,528619,3227,+,Verified
YHR212C,YHR212C,8,537759,538094,335,-,Dubious
YHR212W-A,YHR212W-A,8,538742,538945,203,+,Uncharacterized
YHR213W,YHR213W,8,539151,539747,596,+,Uncharacterized
YHR213W-A,YHR213W-A,8,540549,540782,233,+,Uncharacterized
YHR213W-B,YHR213W-B,8,540800,541099,299,+,Uncharacterized
YHR214W,YHR214W,8,541651,542262,611,+,Uncharacterized
YHR214W-A,YHR214W-A,8,543008,543493,485,+,Dubious
YHR214C-D,YHR214C-D,8,550648,550941,293,-,Uncharacterized
YHR214C-E,YHR214C-E,8,551200,551499,299,-,Uncharacterized
PHO12,YHR215W,8,552099,553502,1403,+,Verified
IMD2,YHR216W,8,554396,555967,1571,+,Verified
YHR217C,YHR217C,8,556581,557042,461,-,Dubious
YHR218W,YHR218W,8,558014,559924,1910,+,Uncharacterized
YHR218W-A,YHR218W-A,8,559932,560249,317,+,Dubious
YHR219W,YHR219W,8,560173,562047,1874,+,Uncharacterized
YHR219C-A,YHR219C-A,8,561199,561681,482,-,Dubious
YIL177C,YIL177C,9,483,6147,5664,-,Uncharacterized
YIL177W-A,YIL177W-A,9,846,1328,482,+,Dubious
PAU14,YIL176C,9,8793,9155,362,-,Uncharacterized
VTH1,YIL173W,9,11492,16141,4649,+,Verified
YIL172C,YIL172C,9,16784,18553,1769,-,Uncharacterized
YIL171W-A,YIL171W-A,9,18260,18712,452,+,Dubious
YIL169C,YIL169C,9,23119,26106,2987,-,Uncharacterized
YIL166C,YIL166C,9,30938,32566,1628,-,Uncharacterized
YIL165C,YIL165C,9,33718,34077,359,-,Uncharacterized
NIT1,YIL164C,9,34087,34686,599,-,Verified
YIL163C,YIL163C,9,36899,37252,353,-,Dubious
SUC2,YIL162W,9,37385,38983,1598,+,Verified
YIL161W,YIL161W,9,39433,40140,707,+,Uncharacterized
POT1,YIL160C,9,40191,41444,1253,-,Verified
BNR1,YIL159W,9,41825,45952,4127,+,Verified
AIM20,YIL158W,9,46201,46815,614,+,Uncharacterized
COA1,YIL157C,9,46949,47542,593,-,Verified
YIL156W-A,YIL156W-A,9,47292,47693,401,+,Dubious
YIL156W-B,YIL156W-B,9,47690,47973,283,+,Uncharacterized
UBP7,YIL156W,9,48091,51306,3215,+,Verified
GUT2,YIL155C,9,51759,53708,1949,-,Verified
IMP2',YIL154C,9,53981,55021,1040,-,Verified
RRD1,YIL153W,9,55198,56379,1181,+,Verified
YIL152W,YIL152W,9,56545,57252,707,+,Uncharacterized
YIL151C,YIL151C,9,57338,60694,3356,-,Uncharacterized
MCM10,YIL150C,9,61013,62728,1715,-,Verified
MLP2,YIL149C,9,63028,68067,5039,-,Verified
RPL40A,YIL148W,9,68708,69528,820,+,Verified
SLN1,YIL147C,9,69791,73453,3662,-,Verified
ECM37,YIL146C,9,74184,75773,1589,-,Verified
PAN6,YIL145C,9,76354,77283,929,-,Verified
TID3,YIL144W,9,78074,80149,2075,+,Verified
SSL2,YIL143C,9,80510,83041,2531,-,Verified
YIL142C-A,YIL142C-A,9,83208,83540,332,-,Dubious
CCT2,YIL142W,9,83302,84885,1583,+,Verified
YIL141W,YIL141W,9,85053,85442,389,+,Dubious
AXL2,YIL140W,9,85366,87837,2471,+,Verified
REV7,YIL139C,9,87979,88716,737,-,Verified
TPM2,YIL138C,9,89230,89715,485,-,Verified
TMA108,YIL137C,9,89948,92788,2840,-,Verified
OM45,YIL136W,9,93619,94800,1181,+,Verified
VHS2,YIL135C,9,95065,96375,1310,-,Verified
YIL134C-A,YIL134C-A,9,96522,96725,203,-,Uncharacterized
FLX1,YIL134W,9,97395,98330,935,+,Verified
RPL16A,YIL133C,9,98527,99416,889,-,Verified
CSM2,YIL132C,9,99860,100501,641,-,Verified
FKH1,YIL131C,9,100781,102235,1454,-,Verified
ASG1,YIL130W,9,102782,105676,2894,+,Verified
TAO3,YIL129C,9,106107,113237,7130,-,Verified
MET18,YIL128W,9,113806,116904,3098,+,Verified
YIL127C,YIL127C,9,117024,117644,620,-,Uncharacterized
STH1,YIL126W,9,117992,122071,4079,+,Verified
KGD1,YIL125W,9,122689,125733,3044,+,Verified
AYR1,YIL124W,9,126204,127097,893,+,Verified
SIM1,YIL123W,9,127662,129578,1916,+,Verified
POG1,YIL122W,9,130607,131662,1055,+,Verified
QDR2,YIL121W,9,132241,133869,1628,+,Verified
QDR1,YIL120W,9,134414,136105,1691,+,Verified
RPI1,YIL119C,9,136651,137874,1223,-,Verified
RHO3,YIL118W,9,139749,140444,695,+,Verified
PRM5,YIL117C,9,140610,141566,956,-,Verified
HIS5,YIL116W,9,142925,144082,1157,+,Verified
YIL115W-A,YIL115W-A,9,144265,144636,371,+,Dubious
NUP159,YIL115C,9,144324,148706,4382,-,Verified
POR2,YIL114C,9,149140,149985,845,-,Verified
SDP1,YIL113W,9,150556,151185,629,+,Verified
HOS4,YIL112W,9,151592,154843,3251,+,Verified
COX5B,YIL111W,9,155219,155762,543,+,Verified
MNI1,YIL110W,9,156042,157175,1133,+,Uncharacterized
SEC24,YIL109C,9,157382,160162,2780,-,Verified
YIL108W,YIL108W,9,160884,162974,2090,+,Uncharacterized
PFK26,YIL107C,9,163275,165758,2483,-,Verified
MOB1,YIL106W,9,166412,167441,1029,+,Verified
SLM1,YIL105C,9,167578,169638,2060,-,Verified
YIL105W-A,YIL105W-A,9,167661,167801,140,+,Dubious
SHQ1,YIL104C,9,169979,171502,1523,-,Verified
DPH1,YIL103W,9,171748,173025,1277,+,Verified
YIL102C-A,YIL102C-A,9,173362,173589,227,-,Uncharacterized
YIL102C,YIL102C,9,174579,174884,305,-,Uncharacterized
XBP1,YIL101C,9,175304,177247,1943,-,Verified
YIL100C-A,YIL100C-A,9,177340,177678,338,-,Dubious
YIL100W,YIL100W,9,177370,177723,353,+,Dubious
SGA1,YIL099W,9,178001,179650,1649,+,Verified
FMC1,YIL098C,9,179769,180236,467,-,Verified
FYV10,YIL097W,9,180424,181974,1550,+,Verified
YIL096C,YIL096C,9,182114,183124,1010,-,Uncharacterized
PRK1,YIL095W,9,183934,186366,2432,+,Verified
LYS12,YIL094C,9,186514,187629,1115,-,Verified
RSM25,YIL093C,9,187987,188781,794,-,Verified
YIL092W,YIL092W,9,189063,190964,1901,+,Uncharacterized
YIL091C,YIL091C,9,191027,193192,2165,-,Uncharacterized
ICE2,YIL090W,9,193592,195067,1475,+,Verified
YIL089W,YIL089W,9,195596,196213,617,+,Uncharacterized
AVT7,YIL088C,9,197928,199400,1472,-,Verified
LRC2,YIL087C,9,199643,200116,473,-,Uncharacterized
YIL086C,YIL086C,9,200150,200458,308,-,Dubious
KTR7,YIL085C,9,200487,202040,1553,-,Verified
SDS3,YIL084C,9,202273,203256,983,-,Verified
YIL083C,YIL083C,9,203553,204650,1097,-,Uncharacterized
YIL082W,YIL082W,9,205632,206504,872,+,Dubious
AIR1,YIL079C,9,210920,212002,1082,-,Verified
THS1,YIL078W,9,212496,214700,2204,+,Verified
YIL077C,YIL077C,9,214988,215950,962,-,Uncharacterized
SEC28,YIL076W,9,216655,217545,890,+,Verified
RPN2,YIL075C,9,217860,220697,2837,-,Verified
SER33,YIL074C,9,221078,222487,1409,-,Verified
SPO22,YIL073C,9,222934,225951,3017,-,Verified
HOP1,YIL072W,9,226599,228416,1817,+,Verified
YIL071W-A,YIL071W-A,9,228547,229023,476,+,Dubious
PCI8,YIL071C,9,228657,229991,1334,-,Verified
MAM33,YIL070C,9,230269,231069,800,-,Verified
RPS24B,YIL069C,9,231550,232366,816,-,Verified
YIL068W-A,YIL068W-A,9,233010,233393,383,+,Dubious
SEC6,YIL068C,9,233054,235471,2417,-,Verified
YIL067C,YIL067C,9,235721,237757,2036,-,Uncharacterized
YIL066W-A,YIL066W-A,9,237363,237806,443,+,Dubious
RNR3,YIL066C,9,238096,240705,2609,-,Verified
FIS1,YIL065C,9,241305,241772,467,-,Verified
YIL064W,YIL064W,9,241940,242713,773,+,Uncharacterized
YRB2,YIL063C,9,242758,243741,983,-,Verified
ARC15,YIL062C,9,243995,244459,464,-,Verified
SNP1,YIL061C,9,244654,245556,902,-,Verified
YIL060W,YIL060W,9,246389,246823,434,+,Uncharacterized
YIL059C,YIL059C,9,246547,246912,365,-,Dubious
YIL058W,YIL058W,9,246911,247195,284,+,Dubious
YIL057C,YIL057C,9,247899,248393,494,-,Uncharacterized
VHR1,YIL056W,9,249989,251911,1922,+,Verified
YIL055C,YIL055C,9,252040,253923,1883,-,Uncharacterized
YIL054W,YIL054W,9,254541,254858,317,+,Dubious
RHR2,YIL053W,9,255113,255865,752,+,Verified
RPL34B,YIL052C,9,256224,257061,837,-,Verified
MMF1,YIL051C,9,257842,258279,437,-,Verified
PCL7,YIL050W,9,258912,259769,857,+,Verified
DFG10,YIL049W,9,260157,260918,761,+,Verified
NEO1,YIL048W,9,261436,264891,3455,+,Verified
YIL047C-A,YIL047C-A,9,265098,265466,368,-,Dubious
SYG1,YIL047C,9,265114,267822,2708,-,Verified
YIL046W-A,YIL046W-A,9,268308,268472,164,+,Uncharacterized
MET30,YIL046W,9,268650,270572,1922,+,Verified
PIG2,YIL045W,9,271160,272776,1616,+,Verified
AGE2,YIL044C,9,272949,273845,896,-,Verified
CBR1,YIL043C,9,274071,274925,854,-,Verified
PKP1,YIL042C,9,275107,276291,1184,-,Verified
GVP36,YIL041W,9,276524,277504,980,+,Verified
APQ12,YIL040W,9,277722,278138,416,+,Verified
TED1,YIL039W,9,278425,279846,1421,+,Uncharacterized
NOT3,YIL038C,9,280141,282651,2510,-,Verified
PRM2,YIL037C,9,283028,284998,1970,-,Verified
CST6,YIL036W,9,285665,287428,1763,+,Verified
CKA1,YIL035C,9,287789,288907,1118,-,Verified
CAP2,YIL034C,9,289225,290088,863,-,Verified
BCY1,YIL033C,9,290418,291668,1250,-,Verified
YIL032C,YIL032C,9,291960,292316,356,-,Dubious
ULP2,YIL031W,9,292632,295736,3104,+,Verified
YIL030W-A,YIL030W-A,9,295564,295902,338,+,Dubious
SSM4,YIL030C,9,296049,300008,3959,-,Verified
YIL029W-A,YIL029W-A,9,299734,300105,371,+,Dubious
YIL029C,YIL029C,9,300827,301255,428,-,Uncharacterized
YIL028W,YIL028W,9,302098,302496,398,+,Dubious
KRE27,YIL027C,9,303677,304102,425,-,Verified
IRR1,YIL026C,9,304475,307927,3452,-,Verified
YIL025C,YIL025C,9,308199,308573,374,-,Dubious
YIL024C,YIL024C,9,308600,309169,569,-,Uncharacterized
YKE4,YIL023C,9,309384,310424,1040,-,Verified
TIM44,YIL022W,9,311163,312458,1295,+,Verified
RPB3,YIL021W,9,312903,313859,956,+,Verified
YIL021C-A,YIL021C-A,9,313197,313466,269,-,Dubious
YIL020C-A,YIL020C-A,9,313711,314049,338,-,Dubious
HIS6,YIL020C,9,314033,314818,785,-,Verified
FAF1,YIL019W,9,315091,316131,1040,+,Verified
RPL2B,YIL018W,9,316766,317930,1164,+,Verified
VID28,YIL017C,9,318198,320963,2765,-,Verified
SNL1,YIL016W,9,321452,321931,479,+,Verified
BAR1,YIL015W,9,322340,324103,1763,+,Verified
YIL014C-A,YIL014C-A,9,325210,325524,314,-,Uncharacterized
MNT3,YIL014W,9,326101,327993,1892,+,Verified
PDR11,YIL013C,9,328205,332440,4235,-,Verified
YIL012W,YIL012W,9,333009,333401,392,+,Dubious
TIR3,YIL011W,9,333724,334533,809,+,Verified
DOT5,YIL010W,9,334879,335526,647,+,Verified
EST3,YIL009C-A,9,335663,336209,546,-,Verified
FAA3,YIL009W,9,339341,341425,2084,+,Verified
URM1,YIL008W,9,342533,342832,299,+,Verified
NAS2,YIL007C,9,342991,343653,662,-,Verified
YIA6,YIL006W,9,344059,345180,1121,+,Verified
EPS1,YIL005W,9,345689,347794,2105,+,Verified
BET1,YIL004C,9,347943,348502,559,-,Verified
CFD1,YIL003W,9,349119,350000,881,+,Verified
YIL002W-A,YIL002W-A,9,350298,350507,209,+,Uncharacterized
INP51,YIL002C,9,350588,353428,2840,-,Verified
YIL001W,YIL001W,9,353937,355478,1541,+,Uncharacterized
SGN1,YIR001C,9,356140,356892,752,-,Verified
MPH1,YIR002C,9,357412,360393,2981,-,Verified
AIM21,YIR003W,9,360882,362921,2039,+,Verified
DJP1,YIR004W,9,363218,364516,1298,+,Verified
IST3,YIR005W,9,364886,365332,446,+,Verified
PAN1,YIR006C,9,365463,369905,4442,-,Verified
YIR007W,YIR007W,9,370701,372995,2294,+,Uncharacterized
PRI1,YIR008C,9,373074,374303,1229,-,Verified
MSL1,YIR009W,9,374522,374857,335,+,Verified
DSN1,YIR010W,9,375428,377158,1730,+,Verified
STS1,YIR011C,9,377284,378243,959,-,Verified
SQT1,YIR012W,9,378483,379778,1295,+,Verified
GAT4,YIR013C,9,380016,380381,365,-,Verified
YIR014W,YIR014W,9,381083,381811,728,+,Uncharacterized
RPR2,YIR015W,9,381945,382379,434,+,Verified
YIR016W,YIR016W,9,382625,383422,797,+,Uncharacterized
MET28,YIR017C,9,383553,384116,563,-,Verified
YIR017W-A,YIR017W-A,9,383563,384162,599,+,Dubious
YAP5,YIR018W,9,384606,385343,737,+,Verified
YIR018C-A,YIR018C-A,9,385561,385698,137,-,Uncharacterized
MUC1,YIR019C,9,389569,393672,4103,-,Verified
YIR020C,YIR020C,9,394252,394554,302,-,Dubious
YIR020W-A,YIR020W-A,9,394914,395156,242,+,Dubious
YIR020C-B,YIR020C-B,9,397212,397946,734,-,Dubious
MRS1,YIR021W,9,397291,398382,1091,+,Verified
YIR021W-A,YIR021W-A,9,398511,398723,212,+,Uncharacterized
SEC11,YIR022W,9,398730,399233,503,+,Verified
DAL81,YIR023W,9,399774,402686,2912,+,Verified
YIR023C-A,YIR023C-A,9,402380,402703,323,-,Dubious
YIR024C,YIR024C,9,402838,403488,650,-,Verified
MND2,YIR025W,9,403656,404762,1106,+,Verified
YVH1,YIR026C,9,404870,405964,1094,-,Verified
DAL1,YIR027C,9,406257,407639,1382,-,Verified
DAL4,YIR028W,9,408465,410372,1907,+,Verified
DAL2,YIR029W,9,410804,411835,1031,+,Verified
DCG1,YIR030C,9,412033,412767,734,-,Verified
YIR030W-A,YIR030W-A,9,412896,413279,383,+,Dubious
DAL7,YIR031C,9,413012,414676,1664,-,Verified
DAL3,YIR032C,9,415027,415614,587,-,Verified
MGA2,YIR033W,9,416121,419462,3341,+,Verified
LYS1,YIR034C,9,419612,420733,1121,-,Verified
YIR035C,YIR035C,9,421023,421787,764,-,Uncharacterized
IRC24,YIR036C,9,422071,422862,791,-,Uncharacterized
YIR036W-A,YIR036W-A,9,422632,423033,401,+,Dubious
HYR1,YIR037W,9,423125,423616,491,+,Verified
GTT1,YIR038C,9,423806,424510,704,-,Verified
YPS6,YIR039C,9,430494,432107,1613,-,Verified
YIR040C,YIR040C,9,433385,433717,332,-,Dubious
PAU15,YIR041W,9,433925,434299,374,+,Uncharacterized
YIR042C,YIR042C,9,435270,435980,710,-,Uncharacterized
YJL225C,YJL225C,10,466,6130,5664,-,Uncharacterized
YJL225W-A,YJL225W-A,10,829,1311,482,+,Dubious
PAU1,YJL223C,10,8776,9138,362,-,Verified
YJL222W-B,YJL222W-B,10,9346,9483,137,+,Dubious
YJL222W-A,YJL222W-A,10,9452,9679,227,+,Dubious
VTH2,YJL222W,10,11475,16124,4649,+,Verified
FSP2,YJL221C,10,16767,18536,1769,-,Verified
YJL220W,YJL220W,10,18243,18695,452,+,Dubious
HXT9,YJL219W,10,19497,21200,1703,+,Verified
YJL218W,YJL218W,10,21973,22563,590,+,Uncharacterized
YJL217W,YJL217W,10,23133,23729,596,+,Uncharacterized
YJL216C,YJL216C,10,24341,26086,1745,-,Uncharacterized
YJL215C,YJL215C,10,26412,26771,359,-,Dubious
HXT8,YJL214W,10,26887,28596,1709,+,Verified
YJL213W,YJL213W,10,32163,33158,995,+,Verified
OPT1,YJL212C,10,33850,36249,2399,-,Verified
YJL211C,YJL211C,10,36757,37200,443,-,Dubious
PEX2,YJL210W,10,36919,37734,815,+,Verified
CBP1,YJL209W,10,38005,39969,1964,+,Verified
NUC1,YJL208C,10,40194,41183,989,-,Verified
LAA1,YJL207C,10,41389,47433,6044,-,Verified
YJL206C,YJL206C,10,47659,49935,2276,-,Uncharacterized
NCE101,YJL205C,10,50139,50443,304,-,Verified
RCY1,YJL204C,10,50629,53151,2522,-,Verified
PRP21,YJL203W,10,53341,54183,842,+,Verified
YJL202C,YJL202C,10,53943,54290,347,-,Dubious
ECM25,YJL201W,10,54379,56178,1799,+,Verified
ACO2,YJL200C,10,56444,58813,2369,-,Verified
MBB1,YJL199C,10,59855,60181,326,-,Dubious
PHO90,YJL198W,10,60843,63488,2645,+,Verified
UBP12,YJL197W,10,63804,67568,3764,+,Verified
YJL197C-A,YJL197C-A,10,65804,66085,281,-,Dubious
ELO1,YJL196C,10,67849,68781,932,-,Verified
YJL195C,YJL195C,10,69240,69941,701,-,Dubious
CDC6,YJL194W,10,69337,70878,1541,+,Verified
YJL193W,YJL193W,10,71365,72573,1208,+,Uncharacterized
SOP4,YJL192C,10,72709,73413,704,-,Verified
RPS14B,YJL191W,10,73786,74610,824,+,Verified
RPS22A,YJL190C,10,74909,75301,392,-,Verified
RPL39,YJL189W,10,75932,76473,541,+,Verified
BUD19,YJL188C,10,76201,76509,308,-,Dubious
SWE1,YJL187C,10,76802,79261,2459,-,Verified
MNN5,YJL186W,10,80153,81913,1760,+,Verified
YJL185C,YJL185C,10,82093,82974,881,-,Uncharacterized
GON7,YJL184W,10,83446,83817,371,+,Verified
MNN11,YJL183W,10,84066,85334,1268,+,Verified
YJL182C,YJL182C,10,85433,85750,317,-,Dubious
YJL181W,YJL181W,10,85658,87493,1835,+,Uncharacterized
ATP12,YJL180C,10,87581,88558,977,-,Verified
PFD1,YJL179W,10,88785,89114,329,+,Verified
ATG27,YJL178C,10,89280,90095,815,-,Verified
RPL17B,YJL177W,10,90784,91655,871,+,Verified
SWI3,YJL176C,10,92051,94528,2477,-,Verified
YJL175W,YJL175W,10,94047,94559,512,+,Dubious
KRE9,YJL174W,10,95090,95920,830,+,Verified
RFA3,YJL173C,10,96159,96527,368,-,Verified
CPS1,YJL172W,10,97731,99461,1730,+,Verified
YJL171C,YJL171C,10,99698,100888,1190,-,Verified
ASG7,YJL170C,10,101144,101773,629,-,Verified
YJL169W,YJL169W,10,102093,102461,368,+,Dubious
SET2,YJL168C,10,102221,104422,2201,-,Verified
ERG20,YJL167W,10,105008,106066,1058,+,Verified
QCR8,YJL166W,10,106428,106712,284,+,Verified
HAL5,YJL165C,10,106888,109455,2567,-,Verified
TPK1,YJL164C,10,109960,111153,1193,-,Verified
YJL163C,YJL163C,10,111662,113329,1667,-,Uncharacterized
JJJ2,YJL162C,10,113874,115625,1751,-,Verified
FMP33,YJL161W,10,117241,117783,542,+,Uncharacterized
YJL160C,YJL160C,10,117958,118821,863,-,Uncharacterized
HSP150,YJL159W,10,120445,121686,1241,+,Verified
CIS3,YJL158C,10,122261,122944,683,-,Verified
FAR1,YJL157C,10,123832,126324,2492,-,Verified
YJL156W-A,YJL156W-A,10,126600,126821,221,+,Dubious
SSY5,YJL156C,10,126886,128949,2063,-,Verified
FBP26,YJL155C,10,129282,130640,1358,-,Verified
VPS35,YJL154C,10,131098,133932,2834,-,Verified
INO1,YJL153C,10,134329,135930,1601,-,Verified
YJL152W,YJL152W,10,136171,136530,359,+,Dubious
SNA3,YJL151C,10,136369,136770,401,-,Verified
YJL150W,YJL150W,10,137120,137422,302,+,Dubious
DAS1,YJL149W,10,137376,139367,1991,+,Verified
RPA34,YJL148W,10,140434,141135,701,+,Verified
YJL147C,YJL147C,10,141416,142564,1148,-,Uncharacterized
IDS2,YJL146W,10,143289,144698,1409,+,Verified
SFH5,YJL145W,10,145157,146041,884,+,Verified
YJL144W,YJL144W,10,146356,146670,314,+,Uncharacterized
TIM17,YJL143W,10,147098,147574,476,+,Verified
IRC9,YJL142C,10,147816,148208,392,-,Dubious
YAK1,YJL141C,10,147964,150387,2423,-,Verified
RPB4,YJL140W,10,150958,151623,665,+,Verified
YUR1,YJL139C,10,151710,152996,1286,-,Verified
TIF2,YJL138C,10,153501,154688,1187,-,Verified
GLG2,YJL137C,10,154982,156124,1142,-,Verified
YJL136W-A,YJL136W-A,10,156166,156249,83,+,Uncharacterized
RPS21B,YJL136C,10,156547,157270,723,-,Verified
YJL135W,YJL135W,10,157874,158191,317,+,Dubious
LCB3,YJL134W,10,158185,159414,1229,+,Verified
YJL133C-A,YJL133C-A,10,159620,159844,224,-,Uncharacterized
MRS3,YJL133W,10,160616,161560,944,+,Verified
YJL132W,YJL132W,10,161911,164163,2252,+,Uncharacterized
AIM23,YJL131C,10,164275,165345,1070,-,Uncharacterized
URA2,YJL130C,10,165720,172749,7029,-,Verified
TRK1,YJL129C,10,173596,177303,3707,-,Verified
PBS2,YJL128C,10,178094,180100,2006,-,Verified
YJL127W-A,YJL127W-A,10,180191,180307,116,+,Dubious
YJL127C-B,YJL127C-B,10,181549,181707,158,-,Uncharacterized
SPT10,YJL127C,10,182296,184218,1922,-,Verified
NIT2,YJL126W,10,184499,185422,923,+,Verified
GCD14,YJL125C,10,185526,186677,1151,-,Verified
LSM1,YJL124C,10,187125,187643,518,-,Verified
MTC1,YJL123C,10,188003,189439,1436,-,Verified
ALB1,YJL122W,10,189715,190242,527,+,Verified
RPE1,YJL121C,10,190373,191089,716,-,Verified
YJL120W,YJL120W,10,191021,191344,323,+,Dubious
YJL119C,YJL119C,10,191571,191894,323,-,Dubious
YJL118W,YJL118W,10,191638,192297,659,+,Verified
PHO86,YJL117W,10,192530,193465,935,+,Verified
NCA3,YJL116C,10,193859,194872,1013,-,Verified
ASF1,YJL115W,10,196285,197124,839,+,Verified
MDV1,YJL112W,10,205301,207445,2144,+,Verified
CCT7,YJL111W,10,207873,209525,1652,+,Verified
GZF3,YJL110C,10,209918,211573,1655,-,Verified
UTP10,YJL109C,10,211996,217305,5309,-,Verified
PRM10,YJL108C,10,217701,218852,1151,-,Verified
YJL107C,YJL107C,10,218849,220012,1163,-,Uncharacterized
IME2,YJL106W,10,221386,223323,1937,+,Verified
SET4,YJL105W,10,225051,226733,1682,+,Verified
PAM16,YJL104W,10,227323,227772,449,+,Verified
GSM1,YJL103C,10,229021,230877,1856,-,Uncharacterized
MEF2,YJL102W,10,231297,233756,2459,+,Verified
GSH1,YJL101C,10,234316,236352,2036,-,Verified
LSB6,YJL100W,10,237259,239082,1823,+,Verified
CHS6,YJL099W,10,239410,241650,2240,+,Verified
SAP185,YJL098W,10,242078,245254,3176,+,Verified
PHS1,YJL097W,10,245587,246240,653,+,Verified
MRPL49,YJL096W,10,246486,246971,485,+,Verified
BCK1,YJL095W,10,247250,251686,4436,+,Verified
KHA1,YJL094C,10,251816,254437,2621,-,Verified
TOK1,YJL093C,10,254732,256807,2075,-,Verified
SRS2,YJL092W,10,257418,260942,3524,+,Verified
GWT1,YJL091C,10,261075,262547,1472,-,Verified
DPB11,YJL090C,10,262752,265046,2294,-,Verified
SIP4,YJL089W,10,265921,268410,2489,+,Verified
ARG3,YJL088W,10,268794,269810,1016,+,Verified
TRL1,YJL087C,10,269997,272480,2483,-,Verified
YJL086C,YJL086C,10,272473,272841,368,-,Dubious
EXO70,YJL085W,10,272822,274693,1871,+,Verified
ALY2,YJL084C,10,274857,277997,3140,-,Verified
TAX4,YJL083W,10,278836,280650,1814,+,Verified
IML2,YJL082W,10,281180,283375,2195,+,Verified
ARP4,YJL081C,10,283797,285266,1469,-,Verified
SCP160,YJL080C,10,285553,289221,3668,-,Verified
PRY1,YJL079C,10,289870,290769,899,-,Verified
PRY3,YJL078C,10,291331,293976,2645,-,Verified
YJL077W-B,YJL077W-B,10,294042,294140,98,+,Uncharacterized
ICS3,YJL077C,10,294661,295056,395,-,Verified
YJL077W-A,YJL077W-A,10,294794,294880,86,+,Dubious
NET1,YJL076W,10,295240,298809,3569,+,Verified
APQ13,YJL075C,10,298455,298871,416,-,Dubious
SMC3,YJL074C,10,299152,302844,3692,-,Verified
JEM1,YJL073W,10,303176,305113,1937,+,Verified
PSF2,YJL072C,10,305216,305857,641,-,Verified
ARG2,YJL071W,10,306127,307851,1724,+,Verified
YJL070C,YJL070C,10,307966,310632,2666,-,Uncharacterized
UTP18,YJL069C,10,310917,312701,1784,-,Verified
YJL068C,YJL068C,10,313011,313910,899,-,Verified
YJL067W,YJL067W,10,314079,314429,350,+,Dubious
MPM1,YJL066C,10,314109,314867,758,-,Verified
DLS1,YJL065C,10,315049,315552,503,-,Verified
YJL064W,YJL064W,10,315170,315565,395,+,Dubious
MRPL8,YJL063C,10,315754,316470,716,-,Verified
YJL062W-A,YJL062W-A,10,316718,316975,257,+,Uncharacterized
LAS21,YJL062W,10,317279,319771,2492,+,Verified
NUP82,YJL061W,10,320011,322152,2141,+,Verified
BNA3,YJL060W,10,323381,324715,1334,+,Verified
YHC3,YJL059W,10,324959,326185,1226,+,Verified
BIT61,YJL058C,10,326237,327868,1631,-,Verified
IKS1,YJL057C,10,328113,330116,2003,-,Verified
ZAP1,YJL056C,10,330426,333068,2642,-,Verified
YJL055W,YJL055W,10,333352,334089,737,+,Uncharacterized
TIM54,YJL054W,10,334260,335696,1436,+,Verified
PEP8,YJL053W,10,335893,337032,1139,+,Verified
YJL052C-A,YJL052C-A,10,337879,337998,119,-,Uncharacterized
TDH1,YJL052W,10,338266,339264,998,+,Verified
IRC8,YJL051W,10,339782,342250,2468,+,Verified
MTR4,YJL050W,10,342517,345738,3221,+,Verified
YJL049W,YJL049W,10,345968,347320,1352,+,Uncharacterized
UBX6,YJL048C,10,347442,348632,1190,-,Verified
YJL047C-A,YJL047C-A,10,349039,349173,134,-,Uncharacterized
RTT101,YJL047C,10,349575,352103,2528,-,Verified
AIM22,YJL046W,10,352381,353610,1229,+,Uncharacterized
YJL045W,YJL045W,10,356019,357923,1904,+,Uncharacterized
GYP6,YJL044C,10,358295,359671,1376,-,Verified
YJL043W,YJL043W,10,360125,360898,773,+,Uncharacterized
MHP1,YJL042W,10,361244,365440,4196,+,Verified
NSP1,YJL041W,10,365779,368368,2589,+,Verified
NUP192,YJL039C,10,368743,373794,5051,-,Verified
LOH1,YJL038C,10,375110,375769,659,-,Uncharacterized
IRC18,YJL037W,10,376657,377331,674,+,Verified
SNX4,YJL036W,10,378820,380091,1271,+,Verified
TAD2,YJL035C,10,380244,380996,752,-,Verified
KAR2,YJL034W,10,381322,383370,2048,+,Verified
HCA4,YJL033W,10,383832,386144,2312,+,Verified
YJL032W,YJL032W,10,386343,386657,314,+,Dubious
BET4,YJL031C,10,386363,387433,1070,-,Verified
MAD2,YJL030W,10,387652,388242,590,+,Verified
VPS53,YJL029C,10,388380,390848,2468,-,Verified
YJL028W,YJL028W,10,391306,391641,335,+,Verified
YJL027C,YJL027C,10,391828,392244,416,-,Uncharacterized
RNR2,YJL026W,10,392399,393598,1199,+,Verified
YJL026C-A,YJL026C-A,10,393061,393282,221,-,Dubious
RRN7,YJL025W,10,393962,395506,1544,+,Verified
APS3,YJL024C,10,395926,396587,661,-,Verified
PET130,YJL023C,10,397350,398393,1043,-,Verified
YJL022W,YJL022W,10,398104,398412,308,+,Dubious
BBC1,YJL020C,10,398932,402405,3473,-,Verified
YJL020W-A,YJL020W-A,10,400976,401233,257,+,Dubious
MPS3,YJL019W,10,402892,404940,2048,+,Verified
YJL016W,YJL016W,10,405583,407268,1685,+,Uncharacterized
YJL015C,YJL015C,10,407137,407511,374,-,Dubious
CCT3,YJL014W,10,407552,409156,1604,+,Verified
MAD3,YJL013C,10,409487,411034,1547,-,Verified
VTC4,YJL012C,10,411228,413393,2165,-,Verified
RPC17,YJL011C,10,414279,414764,485,-,Verified
NOP9,YJL010C,10,417556,419556,2000,-,Verified
YJL009W,YJL009W,10,419849,420175,326,+,Dubious
CCT8,YJL008C,10,419951,421657,1706,-,Verified
YJL007C,YJL007C,10,422692,423006,314,-,Dubious
CTK2,YJL006C,10,423132,424103,971,-,Verified
CYR1,YJL005W,10,425151,431231,6080,+,Verified
SYS1,YJL004C,10,431583,432194,611,-,Verified
COX16,YJL003W,10,432638,432994,356,+,Verified
OST1,YJL002C,10,433215,434645,1430,-,Verified
PRE3,YJL001W,10,435157,435920,763,+,Verified
AVT1,YJR001W,10,436796,438604,1808,+,Verified
MPP10,YJR002W,10,438858,440639,1781,+,Verified
YJR003C,YJR003C,10,440987,442546,1559,-,Uncharacterized
SAG1,YJR004C,10,442902,444854,1952,-,Verified
APL1,YJR005W,10,445916,448018,2102,+,Verified
YJR005C-A,YJR005C-A,10,448470,448751,281,-,Uncharacterized
POL31,YJR006W,10,449195,450658,1463,+,Verified
SUI2,YJR007W,10,451013,451927,914,+,Verified
YJR008W,YJR008W,10,452423,453439,1016,+,Uncharacterized
TDH2,YJR009C,10,453676,454674,998,-,Verified
MET3,YJR010W,10,456232,457767,1535,+,Verified
SPC1,YJR010C-A,10,458070,458354,284,-,Verified
YJR011C,YJR011C,10,458634,459419,785,-,Uncharacterized
YJR012C,YJR012C,10,459788,460411,623,-,Uncharacterized
GPI14,YJR013W,10,460375,461586,1211,+,Verified
TMA22,YJR014W,10,461822,462418,596,+,Verified
YJR015W,YJR015W,10,462714,464246,1532,+,Uncharacterized
ILV3,YJR016C,10,464444,466201,1757,-,Verified
ESS1,YJR017C,10,466514,467026,512,-,Verified
YJR018W,YJR018W,10,466779,467141,362,+,Dubious
TES1,YJR019C,10,467225,468274,1049,-,Verified
YJR020W,YJR020W,10,467994,468326,332,+,Dubious
REC107,YJR021C,10,468548,469572,1024,-,Verified
LSM8,YJR022W,10,469777,470106,329,+,Verified
YJR023C,YJR023C,10,469797,470198,401,-,Dubious
MDE1,YJR024C,10,470223,470957,734,-,Uncharacterized
BNA1,YJR025C,10,471131,471664,533,-,Verified
YJR030C,YJR030C,10,483952,486189,2237,-,Uncharacterized
GEA1,YJR031C,10,486579,490805,4226,-,Verified
CPR7,YJR032W,10,491074,492255,1181,+,Verified
RAV1,YJR033C,10,492371,496444,4073,-,Verified
PET191,YJR034W,10,496676,497002,326,+,Verified
RAD26,YJR035W,10,497348,500605,3257,+,Verified
HUL4,YJR036C,10,500706,503384,2678,-,Verified
YJR037W,YJR037W,10,503095,503478,383,+,Dubious
YJR038C,YJR038C,10,503703,504065,362,-,Dubious
YJR039W,YJR039W,10,503929,507294,3365,+,Uncharacterized
GEF1,YJR040W,10,507739,510078,2339,+,Verified
URB2,YJR041C,10,510232,513756,3524,-,Verified
NUP85,YJR042W,10,514048,516282,2234,+,Verified
POL32,YJR043C,10,516454,517506,1052,-,Verified
VPS55,YJR044C,10,518756,519178,422,-,Verified
SSC1,YJR045C,10,519631,521595,1964,-,Verified
TAH11,YJR046W,10,522041,523855,1814,+,Verified
ANB1,YJR047C,10,524901,525374,473,-,Verified
CYC1,YJR048W,10,526328,526657,329,+,Verified
UTR1,YJR049C,10,526877,528469,1592,-,Verified
ISY1,YJR050W,10,528690,529397,707,+,Verified
OSM1,YJR051W,10,529854,531359,1505,+,Verified
RAD7,YJR052W,10,532055,533752,1697,+,Verified
BFA1,YJR053W,10,534020,535744,1724,+,Verified
YJR054W,YJR054W,10,536049,537542,1493,+,Uncharacterized
HIT1,YJR055W,10,538765,539259,494,+,Verified
YJR056C,YJR056C,10,541785,542495,710,-,Uncharacterized
CDC8,YJR057W,10,544055,544705,650,+,Verified
APS2,YJR058C,10,544725,545168,443,-,Verified
PTK2,YJR059W,10,545780,548236,2456,+,Verified
CBF1,YJR060W,10,548752,549807,1055,+,Verified
YJR061W,YJR061W,10,550504,553311,2807,+,Uncharacterized
NTA1,YJR062C,10,553469,554842,1373,-,Verified
RPA12,YJR063W,10,555188,555565,377,+,Verified
CCT5,YJR064W,10,555907,557595,1688,+,Verified
ARP3,YJR065C,10,557802,559151,1349,-,Verified
TOR1,YJR066W,10,559409,566821,7412,+,Verified
YAE1,YJR067C,10,567012,567437,425,-,Verified
RFC2,YJR068W,10,567636,568697,1061,+,Verified
HAM1,YJR069C,10,568799,569392,593,-,Verified
LIA1,YJR070C,10,569614,570591,977,-,Verified
YJR071W,YJR071W,10,570398,570766,368,+,Dubious
NPA3,YJR072C,10,570960,572117,1157,-,Verified
OPI3,YJR073C,10,572308,572928,620,-,Verified
MOG1,YJR074W,10,573088,573744,656,+,Verified
HOC1,YJR075W,10,573974,575164,1190,+,Verified
CDC11,YJR076C,10,575347,576594,1247,-,Verified
MIR1,YJR077C,10,577248,578183,935,-,Verified
BNA2,YJR078W,10,578853,580214,1361,+,Verified
YJR079W,YJR079W,10,580198,581232,1034,+,Uncharacterized
AIM24,YJR080C,10,580425,581609,1184,-,Uncharacterized
EAF6,YJR082C,10,581907,582248,341,-,Verified
ACF4,YJR083C,10,582601,583530,929,-,Verified
CSN12,YJR084W,10,583726,584997,1271,+,Verified
YJR085C,YJR085C,10,585113,585430,317,-,Uncharacterized
STE18,YJR086W,10,586061,586393,332,+,Verified
YJR087W,YJR087W,10,586393,586743,350,+,Dubious
YJR088C,YJR088C,10,586488,587366,878,-,Uncharacterized
BIR1,YJR089W,10,587711,590575,2864,+,Verified
GRR1,YJR090C,10,590865,594320,3455,-,Verified
JSN1,YJR091C,10,595054,598329,3275,-,Verified
BUD4,YJR092W,10,598728,603071,4343,+,Verified
FIP1,YJR093C,10,603213,604196,983,-,Verified
IME1,YJR094C,10,604562,605644,1082,-,Verified
RPL43B,YJR094W-A,10,608298,608851,553,+,Verified
SFC1,YJR095W,10,609766,610734,968,+,Verified
YJR096W,YJR096W,10,611188,612036,848,+,Verified
JJJ3,YJR097W,10,612406,612924,518,+,Verified
YJR098C,YJR098C,10,613179,615146,1967,-,Uncharacterized
YUH1,YJR099W,10,615566,616276,710,+,Verified
AIM25,YJR100C,10,616341,617324,983,-,Uncharacterized
RSM26,YJR101W,10,618224,619024,800,+,Verified
VPS25,YJR102C,10,619147,619755,608,-,Verified
URA8,YJR103W,10,620744,622438,1694,+,Verified
SOD1,YJR104C,10,622539,623003,464,-,Verified
ADO1,YJR105W,10,623570,624592,1022,+,Verified
ECM27,YJR106W,10,624827,627004,2177,+,Verified
YJR107W,YJR107W,10,627330,628316,986,+,Uncharacterized
ABM1,YJR108W,10,628703,629074,371,+,Verified
CPA2,YJR109C,10,629576,632932,3356,-,Verified
YMR1,YJR110W,10,633606,635672,2066,+,Verified
YJR111C,YJR111C,10,635846,636697,851,-,Uncharacterized
NNF1,YJR112W,10,637021,637626,605,+,Verified
YJR112W-A,YJR112W-A,10,637781,638159,378,+,Uncharacterized
RSM7,YJR113C,10,638223,638966,743,-,Verified
YJR114W,YJR114W,10,638650,639042,392,+,Dubious
YJR115W,YJR115W,10,639933,640442,509,+,Uncharacterized
YJR116W,YJR116W,10,640816,641655,839,+,Uncharacterized
STE24,YJR117W,10,641998,643359,1361,+,Verified
ILM1,YJR118C,10,643481,644092,611,-,Verified
JHD2,YJR119C,10,644295,646481,2186,-,Verified
YJR120W,YJR120W,10,647117,647467,350,+,Verified
ATP2,YJR121W,10,647598,649133,1535,+,Verified
IBA57,YJR122W,10,649767,651260,1493,+,Verified
RPS5,YJR123W,10,651892,652569,677,+,Verified
YJR124C,YJR124C,10,652883,654229,1346,-,Uncharacterized
ENT3,YJR125C,10,654728,655954,1226,-,Verified
VPS70,YJR126C,10,656245,658680,2435,-,Verified
RSF2,YJR127C,10,658908,663050,4142,-,Verified
YJR128W,YJR128W,10,662912,663271,359,+,Dubious
YJR129C,YJR129C,10,663991,665010,1019,-,Uncharacterized
STR2,YJR130C,10,665209,667128,1919,-,Verified
MNS1,YJR131W,10,667635,669284,1649,+,Verified
NMD5,YJR132W,10,669513,672659,3146,+,Verified
XPT1,YJR133W,10,672982,673611,629,+,Verified
SGM1,YJR134C,10,673720,675843,2123,-,Verified
MCM22,YJR135C,10,676050,676769,719,-,Verified
TIM8,YJR135W-A,10,676962,677225,263,+,Verified
YJR136C,YJR136C,10,677432,678697,1265,-,Uncharacterized
ECM17,YJR137C,10,678948,683276,4328,-,Verified
IML1,YJR138W,10,684558,689312,4754,+,Verified
HOM6,YJR139C,10,689436,690515,1079,-,Verified
HIR3,YJR140C,10,690741,695687,4946,-,Verified
YJR140W-A,YJR140W-A,10,690952,691101,149,+,Dubious
YJR141W,YJR141W,10,695897,696940,1043,+,Uncharacterized
YJR142W,YJR142W,10,697132,698160,1028,+,Uncharacterized
PMT4,YJR143C,10,698317,700605,2288,-,Verified
MGM101,YJR144W,10,700873,701682,809,+,Verified
RPS4A,YJR145C,10,702018,703059,1041,-,Verified
YJR146W,YJR146W,10,703876,704229,353,+,Dubious
HMS2,YJR147W,10,704187,705263,1076,+,Verified
BAT2,YJR148W,10,705735,706865,1130,+,Verified
YJR149W,YJR149W,10,707151,708365,1214,+,Uncharacterized
DAN1,YJR150C,10,708802,709698,896,-,Verified
DAN4,YJR151C,10,712246,715731,3485,-,Verified
YJR151W-A,YJR151W-A,10,717571,717621,50,+,Uncharacterized
DAL5,YJR152W,10,719657,721288,1631,+,Verified
PGU1,YJR153W,10,722806,723891,1085,+,Verified
YJR154W,YJR154W,10,725775,726815,1040,+,Uncharacterized
AAD10,YJR155W,10,727396,728262,866,+,Verified
THI11,YJR156C,10,728565,729587,1022,-,Verified
YJR157W,YJR157W,10,730506,730868,362,+,Dubious
HXT16,YJR158W,10,732431,734134,1703,+,Verified
SOR1,YJR159W,10,736035,737108,1073,+,Verified
MPH3,YJR160C,10,737999,739807,1808,-,Verified
COS5,YJR161C,10,742839,743990,1151,-,Verified
YJR162C,YJR162C,10,744902,745252,350,-,Dubious
YKL225W,YKL225W,11,452,799,347,+,Dubious
PAU16,YKL224C,11,1811,2182,371,-,Uncharacterized
YKL223W,YKL223W,11,2390,2722,332,+,Dubious
YKL222C,YKL222C,11,3504,5621,2117,-,Verified
MCH2,YKL221W,11,6108,7529,1421,+,Verified
FRE2,YKL220C,11,9092,11227,2135,-,Verified
COS9,YKL219W,11,14485,15708,1223,+,Verified
SRY1,YKL218C,11,17359,18339,980,-,Verified
JEN1,YKL217W,11,22234,24084,1850,+,Verified
URA1,YKL216W,11,25216,26160,944,+,Verified
YKL215C,YKL215C,11,26828,30688,3860,-,Uncharacterized
YRA2,YKL214C,11,31083,31694,611,-,Verified
DOA1,YKL213C,11,31961,34108,2147,-,Verified
SAC1,YKL212W,11,34544,36415,1871,+,Verified
TRP3,YKL211C,11,36700,38154,1454,-,Verified
UBA1,YKL210W,11,39164,42238,3074,+,Verified
STE6,YKL209C,11,42424,46296,3872,-,Verified
CBT1,YKL208W,11,47158,47973,815,+,Verified
LRC3,YKL207W,11,48195,48956,761,+,Uncharacterized
ADD66,YKL206C,11,49007,49810,803,-,Verified
LOS1,YKL205W,11,50052,53354,3302,+,Verified
EAP1,YKL204W,11,53705,55603,1898,+,Verified
TOR2,YKL203C,11,55936,63360,7424,-,Verified
YKL202W,YKL202W,11,63822,64403,581,+,Dubious
MNN4,YKL201C,11,63931,67467,3536,-,Verified
PTK1,YKL198C,11,68274,70223,1949,-,Verified
PEX1,YKL197C,11,70739,73870,3131,-,Verified
YKT6,YKL196C,11,74937,75539,602,-,Verified
MIA40,YKL195W,11,75826,77037,1211,+,Verified
MST1,YKL194C,11,77263,78651,1388,-,Verified
SDS22,YKL193C,11,78871,79887,1016,-,Verified
ACP1,YKL192C,11,80165,80542,377,-,Verified
DPH2,YKL191W,11,81040,82644,1604,+,Verified
CNB1,YKL190W,11,82952,83555,603,+,Verified
HYM1,YKL189W,11,84709,85908,1199,+,Verified
PXA2,YKL188C,11,86230,88791,2561,-,Verified
YKL187C,YKL187C,11,89289,91541,2252,-,Uncharacterized
MTR2,YKL186C,11,92749,93470,721,-,Verified
ASH1,YKL185W,11,94504,96270,1766,+,Verified
SPE1,YKL184W,11,96762,98162,1400,+,Verified
YKL183C-A,YKL183C-A,11,98400,98612,212,-,Uncharacterized
LOT5,YKL183W,11,98726,99646,920,+,Verified
FAS1,YKL182W,11,100676,106831,6155,+,Verified
PRS1,YKL181W,11,107321,108604,1283,+,Verified
RPL17A,YKL180W,11,109274,110134,860,+,Verified
COY1,YKL179C,11,110469,112508,2039,-,Verified
STE3,YKL178C,11,113220,114632,1412,-,Verified
YKL177W,YKL177W,11,114361,114699,338,+,Dubious
LST4,YKL176C,11,115505,117991,2486,-,Verified
ZRT3,YKL175W,11,118798,120309,1511,+,Verified
TPO5,YKL174C,11,120385,122241,1856,-,Verified
SNU114,YKL173W,11,122522,125548,3026,+,Verified
EBP2,YKL172W,11,125764,127047,1283,+,Verified
YKL171W,YKL171W,11,127480,130266,2786,+,Uncharacterized
MRPL38,YKL170W,11,130639,131055,416,+,Verified
YKL169C,YKL169C,11,130690,131073,383,-,Dubious
KKQ8,YKL168C,11,131293,133467,2174,-,Verified
MRP49,YKL167C,11,133726,134139,413,-,Verified
TPK3,YKL166C,11,134514,135710,1196,-,Verified
YKL165C-A,YKL165C-A,11,135795,136028,233,-,Dubious
MCD4,YKL165C,11,137937,140696,2759,-,Verified
PIR1,YKL164C,11,141799,142824,1025,-,Verified
PIR3,YKL163W,11,144406,145383,977,+,Verified
YKL162C-A,YKL162C-A,11,145927,146079,152,-,Dubious
YKL162C,YKL162C,11,147635,148843,1208,-,Uncharacterized
YKL161C,YKL161C,11,149391,150692,1301,-,Verified
ELF1,YKL160W,11,153274,153711,437,+,Verified
RCN1,YKL159C,11,153821,154456,635,-,Verified
APE2,YKL157W,11,154996,158186,3190,+,Verified
RPS27A,YKL156W,11,158619,159217,598,+,Verified
YKL156C-A,YKL156C-A,11,158980,159096,116,-,Dubious
RSM22,YKL155C,11,159461,161347,1886,-,Verified
SRP102,YKL154W,11,161606,162340,734,+,Verified
YKL153W,YKL153W,11,163605,164114,509,+,Dubious
GPM1,YKL152C,11,163647,164390,743,-,Verified
YKL151C,YKL151C,11,164922,165935,1013,-,Uncharacterized
MCR1,YKL150W,11,166405,167457,1052,+,Verified
DBR1,YKL149C,11,167617,168834,1217,-,Verified
SDH1,YKL148C,11,169212,171134,1922,-,Verified
YKL147C,YKL147C,11,171556,172173,617,-,Dubious
AVT3,YKL146W,11,171788,173866,2078,+,Verified
RPT1,YKL145W,11,174218,175621,1403,+,Verified
YKL145W-A,YKL145W-A,11,174963,175055,92,+,Dubious
RPC25,YKL144C,11,175848,176486,638,-,Verified
LTV1,YKL143W,11,176786,178177,1391,+,Verified
MRP8,YKL142W,11,178520,179179,659,+,Verified
SDH3,YKL141W,11,179672,180268,596,+,Verified
TGL1,YKL140W,11,180784,182430,1646,+,Verified
CTK1,YKL139W,11,182963,184549,1586,+,Verified
HSK3,YKL138C-A,11,184808,185017,209,-,Verified
MRPL31,YKL138C,11,185291,185686,395,-,Verified
CMC1,YKL137W,11,185962,186297,335,+,Verified
YKL136W,YKL136W,11,186421,186819,398,+,Dubious
APL2,YKL135C,11,186465,188645,2180,-,Verified
OCT1,YKL134C,11,189129,191441,2312,-,Verified
YKL133C,YKL133C,11,191678,193069,1391,-,Uncharacterized
RMA1,YKL132C,11,193573,194865,1292,-,Verified
YKL131W,YKL131W,11,194477,194998,521,+,Dubious
SHE2,YKL130C,11,195287,196027,740,-,Verified
MYO3,YKL129C,11,196348,200163,3815,-,Verified
PMU1,YKL128C,11,200528,201415,887,-,Verified
PGM1,YKL127W,11,203185,204897,1712,+,Verified
YPK1,YKL126W,11,205351,207393,2042,+,Verified
RRN3,YKL125W,11,207891,209774,1883,+,Verified
SSH4,YKL124W,11,210237,211976,1739,+,Verified
YKL123W,YKL123W,11,211687,212067,380,+,Dubious
SRP21,YKL122C,11,212139,212642,503,-,Verified
YKL121W,YKL121W,11,213786,216344,2558,+,Uncharacterized
OAC1,YKL120W,11,216988,217962,974,+,Verified
VPH2,YKL119C,11,218214,218861,647,-,Verified
YKL118W,YKL118W,11,218770,219081,311,+,Dubious
SBA1,YKL117W,11,219968,220618,650,+,Verified
PRR1,YKL116C,11,220988,222544,1556,-,Verified
YKL115C,YKL115C,11,222537,222929,392,-,Dubious
APN1,YKL114C,11,222996,224099,1103,-,Verified
RAD27,YKL113C,11,224371,225519,1148,-,Verified
ABF1,YKL112W,11,226214,228409,2195,+,Verified
YKL111C,YKL111C,11,228108,228443,335,-,Dubious
KTI12,YKL110C,11,228583,229524,941,-,Verified
HAP4,YKL109W,11,231871,233535,1664,+,Verified
SLD2,YKL108W,11,234070,235431,1361,+,Verified
YKL107W,YKL107W,11,235785,236714,929,+,Uncharacterized
YKL106C-A,YKL106C-A,11,236791,236910,119,-,Uncharacterized
AAT1,YKL106W,11,237180,238535,1355,+,Verified
YKL105C,YKL105C,11,238829,242227,3398,-,Uncharacterized
GFA1,YKL104C,11,242864,245017,2153,-,Verified
LAP4,YKL103C,11,245782,247326,1544,-,Verified
YKL102C,YKL102C,11,247706,248011,305,-,Dubious
HSL1,YKL101W,11,248564,253120,4556,+,Verified
YKL100C,YKL100C,11,253341,255104,1763,-,Uncharacterized
YKL100W-A,YKL100W-A,11,253803,253892,89,+,Dubious
UTP11,YKL099C,11,255364,256116,752,-,Verified
MTC2,YKL098W,11,256414,257487,1073,+,Uncharacterized
YKL097C,YKL097C,11,258147,258557,410,-,Dubious
YKL096C-B,YKL096C-B,11,258717,258866,149,-,Uncharacterized
CWP2,YKL096W-A,11,258897,259175,278,+,Verified
CWP1,YKL096W,11,260776,261495,719,+,Verified
YJU2,YKL095W,11,261921,262757,836,+,Verified
YJU3,YKL094W,11,262993,263934,941,+,Verified
MBR1,YKL093W,11,264433,265452,1019,+,Verified
BUD2,YKL092C,11,265789,269103,3314,-,Verified
YKL091C,YKL091C,11,269362,270294,932,-,Verified
CUE2,YKL090W,11,271522,272853,1331,+,Verified
MIF2,YKL089W,11,273038,274687,1649,+,Verified
YKL088W,YKL088W,11,274927,276642,1715,+,Uncharacterized
CYT2,YKL087C,11,276833,277507,674,-,Verified
SRX1,YKL086W,11,277925,278308,383,+,Verified
MDH1,YKL085W,11,278767,279771,1004,+,Verified
HOT13,YKL084W,11,280153,280503,350,+,Verified
YKL083W,YKL083W,11,280565,281179,614,+,Dubious
RRP14,YKL082C,11,280669,281973,1304,-,Verified
TEF4,YKL081W,11,282535,284099,1564,+,Verified
VMA5,YKL080W,11,284674,285852,1178,+,Verified
SMY1,YKL079W,11,286247,288217,1970,+,Verified
DHR2,YKL078W,11,288489,290696,2207,+,Verified
YKL077W,YKL077W,11,291097,292275,1178,+,Uncharacterized
PSY1,YKL076C,11,292482,292865,383,-,Dubious
YKL075C,YKL075C,11,292600,293952,1352,-,Uncharacterized
MUD2,YKL074C,11,294254,295837,1583,-,Verified
LHS1,YKL073W,11,296074,298719,2645,+,Verified
STB6,YKL072W,11,299226,301526,2300,+,Verified
YKL071W,YKL071W,11,304758,305528,770,+,Uncharacterized
YKL070W,YKL070W,11,305855,306364,509,+,Uncharacterized
YKL069W,YKL069W,11,306929,307471,542,+,Uncharacterized
YKL068W-A,YKL068W-A,11,308850,309086,236,+,Uncharacterized
NUP100,YKL068W,11,309843,312722,2879,+,Verified
YNK1,YKL067W,11,314456,314917,461,+,Verified
YKL066W,YKL066W,11,314925,315368,443,+,Dubious
YKL065W-A,YKL065W-A,11,315598,315819,221,+,Uncharacterized
YET1,YKL065C,11,316081,316701,620,-,Verified
MNR2,YKL064W,11,317408,320317,2909,+,Verified
YKL063C,YKL063C,11,320659,321162,503,-,Uncharacterized
MSN4,YKL062W,11,322872,324764,1892,+,Verified
YKL061W,YKL061W,11,325415,325756,341,+,Uncharacterized
FBA1,YKL060C,11,326052,327131,1079,-,Verified
MPE1,YKL059C,11,327762,329087,1325,-,Verified
TOA2,YKL058W,11,329810,330178,368,+,Verified
NUP120,YKL057C,11,330500,333613,3113,-,Verified
TMA19,YKL056C,11,334056,334559,503,-,Verified
OAR1,YKL055C,11,334965,335801,836,-,Verified
DEF1,YKL054C,11,336181,338397,2216,-,Verified
MDM35,YKL053C-A,11,338826,339086,260,-,Verified
YKL053W,YKL053W,11,339216,339590,374,+,Dubious
ASK1,YKL052C,11,339312,340190,878,-,Verified
SFK1,YKL051W,11,340956,342017,1061,+,Verified
YKL050C,YKL050C,11,342496,345264,2768,-,Verified
CSE4,YKL049C,11,345719,346408,689,-,Verified
ELM1,YKL048C,11,346858,348780,1922,-,Verified
YKL047W,YKL047W,11,349107,350657,1550,+,Uncharacterized
DCW1,YKL046C,11,350919,352268,1349,-,Verified
PRI2,YKL045W,11,353137,354723,1586,+,Verified
YKL044W,YKL044W,11,355966,356286,320,+,Dubious
PHD1,YKL043W,11,356392,357492,1100,+,Verified
SPC42,YKL042W,11,358119,359210,1091,+,Verified
VPS24,YKL041W,11,359786,360460,674,+,Verified
NFU1,YKL040C,11,360701,361471,770,-,Verified
PTM1,YKL039W,11,362265,363836,1571,+,Verified
RGT1,YKL038W,11,365248,368760,3512,+,Verified
AIM26,YKL037W,11,369008,369364,356,+,Uncharacterized
YKL036C,YKL036C,11,369171,369563,392,-,Dubious
UGP1,YKL035W,11,369534,371033,1499,+,Verified
TUL1,YKL034W,11,371472,373748,2276,+,Verified
YKL033W-A,YKL033W-A,11,374148,374858,710,+,Uncharacterized
YKL033W,YKL033W,11,375099,378215,3116,+,Uncharacterized
IXR1,YKL032C,11,379708,381501,1793,-,Verified
YKL031W,YKL031W,11,381715,382128,413,+,Dubious
YKL030W,YKL030W,11,382141,382746,605,+,Dubious
MAE1,YKL029C,11,382359,384368,2009,-,Verified
TFA1,YKL028W,11,385401,386849,1448,+,Verified
YKL027W,YKL027W,11,387205,388548,1343,+,Verified
GPX1,YKL026C,11,389023,389526,503,-,Verified
PAN3,YKL025C,11,389883,391922,2039,-,Verified
URA6,YKL024C,11,392169,392783,614,-,Verified
YKL023C-A,YKL023C-A,11,392789,393016,227,-,Uncharacterized
YKL023W,YKL023W,11,393364,394197,833,+,Uncharacterized
CDC16,YKL022C,11,394369,396891,2522,-,Verified
MAK11,YKL021C,11,396987,398393,1406,-,Verified
SPT23,YKL020C,11,398475,401723,3248,-,Verified
RAM2,YKL019W,11,402211,403161,950,+,Verified
YKL018C-A,YKL018C-A,11,403223,403522,299,-,Uncharacterized
SWD2,YKL018W,11,403745,404734,989,+,Verified
HCS1,YKL017C,11,404833,406884,2051,-,Verified
ATP7,YKL016C,11,407108,407632,524,-,Verified
PUT3,YKL015W,11,408187,411126,2939,+,Verified
URB1,YKL014C,11,411262,416556,5294,-,Verified
ARC19,YKL013C,11,417151,417666,515,-,Verified
PRP40,YKL012W,11,417953,419704,1751,+,Verified
CCE1,YKL011C,11,419798,420859,1061,-,Verified
UFD4,YKL010C,11,421067,425518,4451,-,Verified
MRT4,YKL009W,11,425885,426595,710,+,Verified
LAC1,YKL008C,11,426938,428194,1256,-,Verified
CAP1,YKL007W,11,428945,429751,806,+,Verified
SFT1,YKL006C-A,11,429841,430275,434,-,Verified
RPL14A,YKL006W,11,431549,432363,814,+,Verified
BYE1,YKL005C,11,432736,434520,1784,-,Verified
AUR1,YKL004W,11,435223,436428,1205,+,Verified
MRP17,YKL003C,11,436740,437135,395,-,Verified
DID4,YKL002W,11,437421,438187,766,+,Verified
MET14,YKL001C,11,438420,439028,608,-,Verified
VPS1,YKR001C,11,440251,442365,2114,-,Verified
PAP1,YKR002W,11,442875,444581,1706,+,Verified
OSH6,YKR003W,11,445024,446370,1346,+,Verified
ECM9,YKR004C,11,446442,447679,1237,-,Verified
YKR005C,YKR005C,11,448164,449810,1646,-,Uncharacterized
MRPL13,YKR006C,11,450066,450860,794,-,Verified
MEH1,YKR007W,11,451077,451631,554,+,Verified
RSC4,YKR008W,11,451844,453721,1877,+,Verified
FOX2,YKR009C,11,453995,456697,2702,-,Verified
TOF2,YKR010C,11,458567,460882,2315,-,Verified
YKR011C,YKR011C,11,461278,462339,1061,-,Uncharacterized
YKR012C,YKR012C,11,463382,463759,377,-,Dubious
PRY2,YKR013W,11,463602,464591,989,+,Verified
YPT52,YKR014C,11,465010,465714,704,-,Verified
YKR015C,YKR015C,11,466604,468310,1706,-,Uncharacterized
AIM28,YKR016W,11,469360,470982,1622,+,Uncharacterized
YKR017C,YKR017C,11,471337,472992,1655,-,Uncharacterized
YKR018C,YKR018C,11,473366,475543,2177,-,Uncharacterized
IRS4,YKR019C,11,475859,477706,1847,-,Verified
VPS51,YKR020W,11,477981,478475,494,+,Verified
ALY1,YKR021W,11,478877,481624,2747,+,Uncharacterized
NTR2,YKR022C,11,481814,482782,968,-,Verified
YKR023W,YKR023W,11,483062,484654,1592,+,Uncharacterized
DBP7,YKR024C,11,484787,487015,2228,-,Verified
RPC37,YKR025W,11,487413,488261,848,+,Verified
GCN3,YKR026C,11,488381,489298,917,-,Verified
BCH2,YKR027W,11,491007,493304,2297,+,Verified
SAP190,YKR028W,11,493900,497196,3296,+,Verified
SET3,YKR029C,11,497220,499475,2255,-,Verified
GMH1,YKR030W,11,499924,500745,821,+,Verified
SPO14,YKR031C,11,500986,506037,5051,-,Verified
YKR032W,YKR032W,11,506159,506473,314,+,Dubious
YKR033C,YKR033C,11,506521,506946,425,-,Dubious
DAL80,YKR034W,11,506540,507349,809,+,Verified
OPI8,YKR035C,11,507562,508203,641,-,Dubious
DID2,YKR035W-A,11,507581,508195,614,+,Verified
CAF4,YKR036C,11,508344,510275,1931,-,Verified
SPC34,YKR037C,11,510552,511439,887,-,Verified
KAE1,YKR038C,11,511641,512801,1160,-,Verified
GAP1,YKR039W,11,514705,516513,1808,+,Verified
YKR040C,YKR040C,11,517705,518208,503,-,Dubious
YKR041W,YKR041W,11,517840,518592,752,+,Uncharacterized
UTH1,YKR042W,11,519169,520266,1097,+,Verified
YKR043C,YKR043C,11,520539,521354,815,-,Uncharacterized
UIP5,YKR044W,11,521657,522988,1331,+,Verified
YKR045C,YKR045C,11,523060,523611,551,-,Uncharacterized
PET10,YKR046C,11,523865,524716,851,-,Verified
YKR047W,YKR047W,11,524899,525204,305,+,Dubious
NAP1,YKR048C,11,525029,526282,1253,-,Verified
FMP46,YKR049C,11,526472,526873,401,-,Verified
TRK2,YKR050W,11,527457,530126,2669,+,Verified
YKR051W,YKR051W,11,530588,531844,1256,+,Uncharacterized
MRS4,YKR052C,11,532192,533106,914,-,Verified
YSR3,YKR053C,11,533709,534923,1214,-,Verified
DYN1,YKR054C,11,535289,547567,12278,-,Verified
RHO4,YKR055W,11,547858,548733,875,+,Verified
TRM2,YKR056W,11,549090,551009,1919,+,Verified
RPS21A,YKR057W,11,551299,551884,585,+,Verified
GLG1,YKR058W,11,552412,554262,1850,+,Verified
TIF1,YKR059W,11,554629,555816,1187,+,Verified
UTP30,YKR060W,11,556160,556984,824,+,Verified
KTR2,YKR061W,11,557319,558596,1277,+,Verified
TFA2,YKR062W,11,559308,560294,986,+,Verified
LAS1,YKR063C,11,560431,561939,1508,-,Verified
OAF3,YKR064W,11,562189,564780,2591,+,Verified
PAM17,YKR065C,11,564941,565534,593,-,Verified
CCP1,YKR066C,11,565755,566840,1085,-,Verified
GPT2,YKR067W,11,567560,569791,2231,+,Verified
BET3,YKR068C,11,569970,570551,581,-,Verified
MET1,YKR069W,11,571254,573035,1781,+,Verified
YKR070W,YKR070W,11,573216,574274,1058,+,Uncharacterized
DRE2,YKR071C,11,574576,575622,1046,-,Verified
SIS2,YKR072C,11,576077,577765,1688,-,Verified
YKR073C,YKR073C,11,577829,578149,320,-,Dubious
AIM29,YKR074W,11,578851,579318,467,+,Uncharacterized
YKR075C,YKR075C,11,579469,580392,923,-,Uncharacterized
YKR075W-A,YKR075W-A,11,579854,580123,269,+,Dubious
ECM4,YKR076W,11,581925,583037,1112,+,Verified
MSA2,YKR077W,11,583295,584386,1091,+,Uncharacterized
YKR078W,YKR078W,11,584594,586351,1757,+,Verified
TRZ1,YKR079C,11,586431,588947,2516,-,Verified
MTD1,YKR080W,11,590037,590999,962,+,Verified
RPF2,YKR081C,11,591148,592182,1034,-,Verified
NUP133,YKR082W,11,592467,595940,3473,+,Verified
DAD2,YKR083C,11,596063,596464,401,-,Verified
HBS1,YKR084C,11,596697,598532,1835,-,Verified
MRPL20,YKR085C,11,598736,599323,587,-,Verified
PRP16,YKR086W,11,599499,602714,3215,+,Verified
OMA1,YKR087C,11,602837,603874,1037,-,Verified
TVP38,YKR088C,11,604047,605060,1013,-,Verified
TGL4,YKR089C,11,605275,608007,2732,-,Verified
PXL1,YKR090W,11,608588,610708,2120,+,Verified
SRL3,YKR091W,11,611167,611907,740,+,Verified
SRP40,YKR092C,11,612307,613527,1220,-,Verified
PTR2,YKR093W,11,615372,617177,1805,+,Verified
RPL40B,YKR094C,11,617638,618392,754,-,Verified
MLP1,YKR095W,11,619447,625074,5627,+,Verified
PCC1,YKR095W-A,11,625506,625847,341,+,Verified
YKR096W,YKR096W,11,626435,630022,3587,+,Verified
PCK1,YKR097W,11,630790,632439,1649,+,Verified
UBP11,YKR098C,11,632664,634817,2153,-,Verified
BAS1,YKR099W,11,635489,637924,2435,+,Verified
SKG1,YKR100C,11,638539,639606,1067,-,Verified
SIR1,YKR101W,11,640106,642142,2036,+,Verified
FLO10,YKR102W,11,645994,649503,3509,+,Verified
NFT1,YKR103W,11,652718,656374,3656,+,Verified
YKR104W,YKR104W,11,656474,657394,920,+,Verified
VBA5,YKR105C,11,658354,660102,1748,-,Uncharacterized
YKR106W,YKR106W,11,661080,662927,1847,+,Uncharacterized
YLL067C,YLL067C,12,585,4301,3716,-,Uncharacterized
YLL067W-A,YLL067W-A,12,843,1325,482,+,Dubious
YLL066W-B,YLL066W-B,12,5605,5775,170,+,Uncharacterized
YLL066C,YLL066C,12,6120,9836,3716,-,Uncharacterized
YLL066W-A,YLL066W-A,12,6486,6968,482,+,Dubious
YLL065W,YLL065W,12,11726,12076,350,+,Dubious
PAU18,YLL064C,12,13083,13445,362,-,Uncharacterized
AYT1,YLL063C,12,14648,16072,1424,-,Verified
MHT1,YLL062C,12,16639,17613,974,-,Verified
MMP1,YLL061W,12,17956,19707,1751,+,Verified
GTT2,YLL060C,12,21138,21839,701,-,Verified
YLL059C,YLL059C,12,22474,22980,506,-,Dubious
YLL058W,YLL058W,12,23569,25296,1727,+,Uncharacterized
JLP1,YLL057C,12,25756,26994,1238,-,Verified
YLL056C,YLL056C,12,27409,28305,896,-,Uncharacterized
YCT1,YLL055W,12,30109,31704,1595,+,Verified
YLL054C,YLL054C,12,32894,35203,2309,-,Uncharacterized
YLL053C,YLL053C,12,35502,35960,458,-,Uncharacterized
AQY2,YLL052C,12,35911,36360,449,-,Verified
FRE6,YLL051C,12,37332,39470,2138,-,Verified
COF1,YLL050C,12,39803,40413,610,-,Verified
LDB18,YLL049W,12,40665,41204,539,+,Verified
YBT1,YLL048C,12,41279,46264,4985,-,Verified
YLL047W,YLL047W,12,46671,47054,383,+,Dubious
RNP1,YLL046C,12,46713,47462,749,-,Verified
RPL8B,YLL045C,12,47858,48628,770,-,Verified
YLL044W,YLL044W,12,48215,48661,446,+,Dubious
FPS1,YLL043W,12,49937,51946,2009,+,Verified
ATG10,YLL042C,12,52086,52589,503,-,Verified
SDH2,YLL041C,12,53130,53930,800,-,Verified
VPS13,YLL040C,12,54210,63644,9434,-,Verified
UBI4,YLL039C,12,64061,65206,1145,-,Verified
ENT4,YLL038C,12,65774,66517,743,-,Verified
YLL037W,YLL037W,12,66561,66941,380,+,Dubious
PRP19,YLL036C,12,66744,68255,1511,-,Verified
GRC3,YLL035W,12,68579,70477,1898,+,Verified
RIX7,YLL034C,12,70632,73145,2513,-,Verified
IRC19,YLL033W,12,73408,74100,692,+,Verified
YLL032C,YLL032C,12,74269,76746,2477,-,Verified
GPI13,YLL031C,12,77151,80204,3053,-,Verified
YLL030C,YLL030C,12,80355,80696,341,-,Dubious
FRA1,YLL029W,12,81460,83709,2249,+,Verified
TPO1,YLL028W,12,84803,86563,1760,+,Verified
ISA1,YLL027W,12,87402,88154,752,+,Verified
HSP104,YLL026W,12,88622,91348,2726,+,Verified
PAU17,YLL025W,12,94746,95120,374,+,Uncharacterized
SSA2,YLL024C,12,95565,97484,1919,-,Verified
YLL023C,YLL023C,12,97996,98835,839,-,Verified
HIF1,YLL022C,12,99043,100200,1157,-,Verified
SPA2,YLL021W,12,100946,105346,4400,+,Verified
YLL020C,YLL020C,12,105555,105860,305,-,Dubious
KNS1,YLL019C,12,105685,107898,2213,-,Verified
YLL019W-A,YLL019W-A,12,106907,106999,92,+,Dubious
COX19,YLL018C-A,12,108675,108971,296,-,Verified
DPS1,YLL018C,12,109901,111574,1673,-,Verified
BPT1,YLL015W,12,116431,121110,4679,+,Verified
YLL014W,YLL014W,12,121321,121647,326,+,Uncharacterized
PUF3,YLL013C,12,122074,124713,2639,-,Verified
YEH1,YLL012W,12,125533,127254,1721,+,Verified
SOF1,YLL011W,12,127522,128991,1469,+,Verified
PSR1,YLL010C,12,129329,130612,1283,-,Verified
COX17,YLL009C,12,131204,131413,209,-,Verified
DRS1,YLL008W,12,131728,133986,2258,+,Verified
YLL007C,YLL007C,12,134301,136298,1997,-,Uncharacterized
YLL006W-A,YLL006W-A,12,136344,136520,176,+,Uncharacterized
MMM1,YLL006W,12,136585,137865,1280,+,Verified
SPO75,YLL005C,12,137939,140545,2606,-,Verified
ORC3,YLL004W,12,141072,142922,1850,+,Verified
SFI1,YLL003W,12,143200,146040,2840,+,Verified
RTT109,YLL002W,12,146290,147600,1310,+,Verified
DNM1,YLL001W,12,147889,150162,2273,+,Verified
YLR001C,YLR001C,12,151388,153976,2588,-,Uncharacterized
NOC3,YLR002C,12,154342,156333,1991,-,Verified
YLR003C,YLR003C,12,156854,157729,875,-,Uncharacterized
THI73,YLR004C,12,157933,159504,1571,-,Verified
SSL1,YLR005W,12,160048,161433,1385,+,Verified
SSK1,YLR006C,12,161754,163892,2138,-,Verified
NSE1,YLR007W,12,164391,165401,1010,+,Verified
PAM18,YLR008C,12,165576,166082,506,-,Verified
RLP24,YLR009W,12,166536,167135,599,+,Verified
TEN1,YLR010C,12,167319,167801,482,-,Verified
LOT6,YLR011W,12,169102,169677,575,+,Verified
YLR012C,YLR012C,12,169981,170280,299,-,Uncharacterized
GAT3,YLR013W,12,171338,171763,425,+,Verified
PPR1,YLR014C,12,172267,174981,2714,-,Verified
BRE2,YLR015W,12,175226,176743,1517,+,Verified
PML1,YLR016C,12,176801,177415,614,-,Verified
MEU1,YLR017W,12,177607,178620,1013,+,Verified
POM34,YLR018C,12,178706,179605,899,-,Verified
PSR2,YLR019W,12,180287,181480,1193,+,Verified
YEH2,YLR020C,12,181788,183404,1616,-,Verified
IRC25,YLR021W,12,183622,184161,539,+,Verified
SDO1,YLR022C,12,184173,184925,752,-,Verified
IZH3,YLR023C,12,185497,187128,1631,-,Verified
UBR2,YLR024C,12,187664,193282,5618,-,Verified
SNF7,YLR025W,12,194453,195175,722,+,Verified
SED5,YLR026C,12,195451,196473,1022,-,Verified
AAT2,YLR027C,12,196830,198086,1256,-,Verified
ADE16,YLR028C,12,199541,201316,1775,-,Verified
RPL15A,YLR029C,12,201977,202591,614,-,Verified
YLR030W,YLR030W,12,203291,204082,791,+,Uncharacterized
YLR031W,YLR031W,12,204226,204786,560,+,Uncharacterized
RAD5,YLR032W,12,204992,208501,3509,+,Verified
RSC58,YLR033W,12,208762,210270,1508,+,Verified
SMF3,YLR034C,12,210513,211934,1421,-,Verified
MLH2,YLR035C,12,212370,214457,2087,-,Verified
YLR036C,YLR036C,12,221522,222133,611,-,Uncharacterized
DAN2,YLR037C,12,222686,223060,374,-,Verified
COX12,YLR038C,12,224922,225173,251,-,Verified
RIC1,YLR039C,12,225427,228597,3170,-,Verified
YLR040C,YLR040C,12,228909,229583,674,-,Uncharacterized
YLR041W,YLR041W,12,229378,229698,320,+,Dubious
YLR042C,YLR042C,12,229967,230452,485,-,Uncharacterized
TRX1,YLR043C,12,231703,232014,311,-,Verified
PDC1,YLR044C,12,232391,234082,1691,-,Verified
STU2,YLR045C,12,235038,237704,2666,-,Verified
YLR046C,YLR046C,12,238002,238814,812,-,Uncharacterized
FRE8,YLR047C,12,239348,241408,2060,-,Verified
RPS0B,YLR048W,12,242233,243350,1117,+,Verified
YLR049C,YLR049C,12,243887,245173,1286,-,Uncharacterized
YLR050C,YLR050C,12,245588,246073,485,-,Uncharacterized
FCF2,YLR051C,12,246325,246978,653,-,Verified
IES3,YLR052W,12,247202,247954,752,+,Verified
YLR053C,YLR053C,12,248101,248427,326,-,Uncharacterized
OSW2,YLR054C,12,248718,250979,2261,-,Uncharacterized
SPT8,YLR055C,12,251273,253081,1808,-,Verified
ERG3,YLR056W,12,253862,254959,1097,+,Verified
YLR057W,YLR057W,12,255307,257856,2549,+,Uncharacterized
SHM2,YLR058C,12,257993,259402,1409,-,Verified
REX2,YLR059C,12,259739,260548,809,-,Verified
FRS1,YLR060W,12,260980,262767,1787,+,Verified
RPL22A,YLR061W,12,263195,263949,754,+,Verified
BUD28,YLR062C,12,263578,263955,377,-,Dubious
YLR063W,YLR063W,12,264158,265255,1097,+,Uncharacterized
YLR064W,YLR064W,12,265457,266278,821,+,Uncharacterized
YLR065C,YLR065C,12,266374,266919,545,-,Uncharacterized
SPC3,YLR066W,12,267170,267724,554,+,Verified
PET309,YLR067C,12,267814,270711,2897,-,Verified
FYV7,YLR068W,12,271009,271464,455,+,Verified
MEF1,YLR069C,12,271631,273916,2285,-,Verified
XYL2,YLR070C,12,274142,275212,1070,-,Verified
RGR1,YLR071C,12,275379,278627,3248,-,Verified
YLR072W,YLR072W,12,278863,280944,2081,+,Uncharacterized
YLR073C,YLR073C,12,281020,281622,602,-,Uncharacterized
BUD20,YLR074C,12,281957,282457,500,-,Verified
RPL10,YLR075W,12,282928,283593,665,+,Verified
YLR076C,YLR076C,12,283186,283608,422,-,Dubious
FMP25,YLR077W,12,283873,285624,1751,+,Uncharacterized
BOS1,YLR078C,12,285737,286560,823,-,Verified
SIC1,YLR079W,12,286821,287675,854,+,Verified
EMP46,YLR080W,12,287917,289251,1334,+,Verified
GAL2,YLR081W,12,290213,291937,1724,+,Verified
SRL2,YLR082C,12,292395,293573,1178,-,Verified
EMP70,YLR083C,12,294092,296095,2003,-,Verified
RAX2,YLR084C,12,296590,300252,3662,-,Verified
ARP6,YLR085C,12,300674,301990,1316,-,Verified
SMC4,YLR086W,12,302244,306500,4256,+,Verified
CSF1,YLR087C,12,306856,315732,8876,-,Verified
GAA1,YLR088W,12,316108,317952,1844,+,Verified
ALT1,YLR089C,12,318238,320016,1778,-,Uncharacterized
XDJ1,YLR090W,12,320702,322081,1379,+,Verified
YLR091W,YLR091W,12,322298,323179,881,+,Uncharacterized
SUL2,YLR092W,12,323545,326226,2681,+,Verified
NYV1,YLR093C,12,326514,327416,902,-,Verified
GIS3,YLR094C,12,327731,329239,1508,-,Verified
IOC2,YLR095C,12,329678,332116,2438,-,Verified
KIN2,YLR096W,12,332591,336034,3443,+,Verified
HRT3,YLR097C,12,336232,337266,1034,-,Verified
CHA4,YLR098C,12,337528,339474,1946,-,Verified
ICT1,YLR099C,12,339745,340929,1184,-,Verified
YLR099W-A,YLR099W-A,12,341326,341589,263,+,Uncharacterized
ERG27,YLR100W,12,341811,342854,1043,+,Verified
YLR101C,YLR101C,12,342567,342962,395,-,Dubious
APC9,YLR102C,12,342971,343768,797,-,Verified
CDC45,YLR103C,12,343990,345942,1952,-,Verified
YLR104W,YLR104W,12,346586,346981,395,+,Uncharacterized
SEN2,YLR105C,12,347048,348181,1133,-,Verified
MDN1,YLR106C,12,349007,363739,14732,-,Verified
REX3,YLR107W,12,364117,365331,1214,+,Verified
YLR108C,YLR108C,12,366668,368125,1457,-,Uncharacterized
AHP1,YLR109W,12,368782,369312,530,+,Verified
CCW12,YLR110C,12,369698,370099,401,-,Verified
YLR111W,YLR111W,12,370392,370724,332,+,Dubious
YLR112W,YLR112W,12,370792,371211,419,+,Dubious
HOG1,YLR113W,12,371621,372928,1307,+,Verified
AVL9,YLR114C,12,374945,377239,2294,-,Verified
CFT2,YLR115W,12,377986,380565,2579,+,Verified
MSL5,YLR116W,12,380823,382253,1430,+,Verified
CLF1,YLR117C,12,382472,384535,2063,-,Verified
YLR118C,YLR118C,12,384726,385409,683,-,Verified
SRN2,YLR119W,12,385535,386176,641,+,Verified
YPS1,YLR120C,12,386512,388221,1709,-,Verified
YLR120W-A,YLR120W-A,12,388673,388774,101,+,Dubious
YPS3,YLR121C,12,388745,390271,1526,-,Verified
YLR122C,YLR122C,12,390955,391332,377,-,Dubious
YLR123C,YLR123C,12,391079,391408,329,-,Dubious
YLR124W,YLR124W,12,391601,391945,344,+,Dubious
YLR125W,YLR125W,12,393485,393895,410,+,Uncharacterized
YLR126C,YLR126C,12,394766,395521,755,-,Uncharacterized
APC2,YLR127C,12,395759,398320,2561,-,Verified
DCN1,YLR128W,12,398531,399434,903,+,Verified
DIP2,YLR129W,12,399658,402489,2831,+,Verified
ZRT2,YLR130C,12,402795,404063,1268,-,Verified
ACE2,YLR131C,12,404511,406823,2312,-,Verified
YLR132C,YLR132C,12,407284,408156,872,-,Uncharacterized
CKI1,YLR133W,12,408446,410194,1748,+,Verified
PDC5,YLR134W,12,410724,412415,1691,+,Verified
SLX4,YLR135W,12,413282,415528,2246,+,Verified
TIS11,YLR136C,12,415802,416659,857,-,Verified
YLR137W,YLR137W,12,417007,418110,1103,+,Uncharacterized
NHA1,YLR138W,12,418438,421395,2957,+,Verified
SLS1,YLR139C,12,421543,423474,1931,-,Verified
YLR140W,YLR140W,12,423475,423801,326,+,Dubious
RRN5,YLR141W,12,423684,424775,1091,+,Verified
PUT1,YLR142W,12,425187,426617,1430,+,Verified
YLR143W,YLR143W,12,427330,429387,2057,+,Uncharacterized
ACF2,YLR144C,12,429678,432017,2339,-,Verified
RMP1,YLR145W,12,432169,432774,605,+,Verified
SPE4,YLR146C,12,432824,433726,902,-,Verified
YLR146W-A,YLR146W-A,12,433871,434059,188,+,Uncharacterized
SMD3,YLR147C,12,434159,434464,305,-,Verified
PEP3,YLR148W,12,434642,437398,2756,+,Verified
YLR149C,YLR149C,12,437632,439824,2192,-,Uncharacterized
YLR149C-A,YLR149C-A,12,440371,440457,86,-,Dubious
STM1,YLR150W,12,440468,441289,821,+,Verified
PCD1,YLR151C,12,441716,442738,1022,-,Verified
YLR152C,YLR152C,12,442959,444689,1730,-,Uncharacterized
ACS2,YLR153C,12,445525,447576,2051,-,Verified
RNH203,YLR154C,12,447983,448315,332,-,Verified
YLR154W-A,YLR154W-A,12,452439,452624,185,+,Dubious
YLR154W-B,YLR154W-B,12,454393,454557,164,+,Dubious
TAR1,YLR154W-C,12,454697,455071,374,+,Verified
YLR154W-E,YLR154W-E,12,455434,455637,203,+,Dubious
YLR154W-F,YLR154W-F,12,455884,456024,140,+,Dubious
YLR154C-G,YLR154C-G,12,462523,462672,149,-,Uncharacterized
YLR154C-H,YLR154C-H,12,468828,468959,131,-,Uncharacterized
ASP3-1,YLR155C,12,469318,470406,1088,-,Verified
YLR156W,YLR156W,12,472114,472458,344,+,Uncharacterized
YLR156C-A,YLR156C-A,12,472480,472611,131,-,Uncharacterized
ASP3-2,YLR157C,12,472970,474058,1088,-,Verified
YLR157W-D,YLR157W-D,12,475765,475977,212,+,Uncharacterized
YLR157W-E,YLR157W-E,12,481874,482038,164,+,Uncharacterized
YLR157C-C,YLR157C-C,12,482060,482191,131,-,Uncharacterized
ASP3-3,YLR158C,12,482550,483638,1088,-,Verified
YLR159W,YLR159W,12,485346,485690,344,+,Uncharacterized
YLR159C-A,YLR159C-A,12,485712,485843,131,-,Uncharacterized
ASP3-4,YLR160C,12,486202,487290,1088,-,Verified
YLR161W,YLR161W,12,488998,489342,344,+,Uncharacterized
YLR162W,YLR162W,12,489574,489930,356,+,Uncharacterized
YLR162W-A,YLR162W-A,12,490407,490595,188,+,Uncharacterized
MAS1,YLR163C,12,491868,493256,1388,-,Verified
YLR163W-A,YLR163W-A,12,492814,492927,113,+,Dubious
YLR164W,YLR164W,12,493885,494391,506,+,Verified
PUS5,YLR165C,12,494496,495260,764,-,Verified
SEC10,YLR166C,12,495431,498046,2615,-,Verified
RPS31,YLR167W,12,498949,499407,458,+,Verified
AIM30,YLR168C,12,499580,500272,692,-,Uncharacterized
YLR169W,YLR169W,12,500337,500690,353,+,Dubious
APS1,YLR170C,12,500581,501051,470,-,Verified
YLR171W,YLR171W,12,500735,501124,389,+,Dubious
DPH5,YLR172C,12,501262,502164,902,-,Verified
YLR173W,YLR173W,12,502423,504249,1826,+,Uncharacterized
IDP2,YLR174W,12,504593,505831,1238,+,Verified
CBF5,YLR175W,12,506136,507587,1451,+,Verified
RFX1,YLR176C,12,507799,510234,2435,-,Verified
YLR177W,YLR177W,12,511056,512942,1886,+,Uncharacterized
TFS1,YLR178C,12,513164,513823,659,-,Verified
YLR179C,YLR179C,12,514110,514715,605,-,Uncharacterized
SAM1,YLR180W,12,515264,516412,1148,+,Verified
VTA1,YLR181C,12,516680,517672,992,-,Verified
SWI6,YLR182W,12,517942,520353,2411,+,Verified
TOS4,YLR183C,12,520545,522014,1469,-,Verified
YLR184W,YLR184W,12,522108,522455,347,+,Dubious
RPL37A,YLR185W,12,522665,523290,625,+,Verified
EMG1,YLR186W,12,523634,524392,758,+,Verified
SKG3,YLR187W,12,524867,527947,3080,+,Uncharacterized
MDL1,YLR188W,12,528302,530389,2087,+,Verified
ATG26,YLR189C,12,530799,534395,3596,-,Verified
MMR1,YLR190W,12,535216,536691,1475,+,Verified
PEX13,YLR191W,12,537274,538434,1160,+,Verified
HCR1,YLR192C,12,538794,539591,797,-,Verified
UPS1,YLR193C,12,540011,540538,527,-,Verified
YLR194C,YLR194C,12,540811,541575,764,-,Uncharacterized
NMT1,YLR195C,12,541939,543306,1367,-,Verified
PWP1,YLR196W,12,543970,545700,1730,+,Verified
SIK1,YLR197W,12,546099,547613,1514,+,Verified
YLR198C,YLR198C,12,547288,547647,359,-,Dubious
PBA1,YLR199C,12,547855,548771,916,-,Verified
YKE2,YLR200W,12,549014,549358,344,+,Verified
COQ9,YLR201C,12,549513,550295,782,-,Verified
YLR202C,YLR202C,12,550196,550638,442,-,Dubious
MSS51,YLR203C,12,550652,551962,1310,-,Verified
QRI5,YLR204W,12,552272,552607,335,+,Verified
HMX1,YLR205C,12,552726,553679,953,-,Verified
ENT2,YLR206W,12,554580,556421,1841,+,Verified
HRD3,YLR207W,12,556790,559291,2501,+,Verified
SEC13,YLR208W,12,559553,560446,893,+,Verified
PNP1,YLR209C,12,560799,561734,935,-,Verified
CLB4,YLR210W,12,562010,563392,1382,+,Verified
YLR211C,YLR211C,12,563794,564533,739,-,Uncharacterized
TUB4,YLR212C,12,564862,566283,1421,-,Verified
CRR1,YLR213C,12,566656,567924,1268,-,Verified
FRE1,YLR214W,12,568569,570629,2060,+,Verified
CDC123,YLR215C,12,570778,571860,1082,-,Verified
CPR6,YLR216C,12,572098,573213,1115,-,Verified
YLR217W,YLR217W,12,572911,573234,323,+,Dubious
YLR218C,YLR218C,12,573468,573920,452,-,Uncharacterized
MSC3,YLR219W,12,574153,576339,2186,+,Verified
CCC1,YLR220W,12,576827,577795,968,+,Verified
RSA3,YLR221C,12,578364,579026,662,-,Verified
UTP13,YLR222C,12,579320,581773,2453,-,Verified
YLR222C-A,YLR222C-A,12,582008,582238,230,-,Dubious
IFH1,YLR223C,12,582235,585492,3257,-,Verified
YLR224W,YLR224W,12,586466,587575,1109,+,Uncharacterized
YLR225C,YLR225C,12,587697,588920,1223,-,Uncharacterized
BUR2,YLR226W,12,589356,590543,1187,+,Verified
ADY4,YLR227C,12,590564,592045,1481,-,Verified
ECM22,YLR228C,12,600021,602465,2444,-,Verified
CDC42,YLR229C,12,604214,604789,575,-,Verified
YLR230W,YLR230W,12,604576,604881,305,+,Dubious
BNA5,YLR231C,12,605760,607121,1361,-,Verified
YLR232W,YLR232W,12,606832,607179,347,+,Dubious
EST1,YLR233C,12,607427,609526,2099,-,Verified
TOP3,YLR234W,12,609785,611755,1970,+,Verified
YLR235C,YLR235C,12,611534,611932,398,-,Dubious
YLR236C,YLR236C,12,611796,612119,323,-,Dubious
THI7,YLR237W,12,612369,614165,1796,+,Verified
FAR10,YLR238W,12,614757,616193,1436,+,Verified
LIP2,YLR239C,12,616334,617320,986,-,Verified
VPS34,YLR240W,12,617535,620162,2627,+,Verified
YLR241W,YLR241W,12,620475,622823,2348,+,Uncharacterized
ARV1,YLR242C,12,622920,623885,965,-,Verified
YLR243W,YLR243W,12,624205,625023,818,+,Uncharacterized
MAP1,YLR244C,12,625170,626333,1163,-,Verified
CDD1,YLR245C,12,626504,626932,428,-,Verified
ERF2,YLR246W,12,627120,628199,1079,+,Verified
IRC20,YLR247C,12,628686,633356,4670,-,Verified
RCK2,YLR248W,12,634254,636086,1832,+,Verified
YEF3,YLR249W,12,636782,639916,3134,+,Verified
SSP120,YLR250W,12,640319,641023,704,+,Verified
SYM1,YLR251W,12,641466,642059,593,+,Verified
YLR252W,YLR252W,12,641959,642264,305,+,Dubious
YLR253W,YLR253W,12,642629,644338,1709,+,Uncharacterized
NDL1,YLR254C,12,644406,644975,569,-,Verified
YLR255C,YLR255C,12,645602,645955,353,-,Dubious
HAP1,YLR256W,12,646417,650925,4508,+,Verified
YLR257W,YLR257W,12,658828,659793,965,+,Uncharacterized
GSY2,YLR258W,12,660718,662835,2117,+,Verified
HSP60,YLR259C,12,663286,665004,1718,-,Verified
LCB5,YLR260W,12,665846,667909,2063,+,Verified
VPS63,YLR261C,12,668239,668565,326,-,Dubious
YPT6,YLR262C,12,668246,668893,647,-,Verified
TMA7,YLR262C-A,12,669470,669664,194,-,Verified
RED1,YLR263W,12,670342,672825,2483,+,Verified
RPS28B,YLR264W,12,673133,673336,203,+,Verified
YLR264C-A,YLR264C-A,12,673830,673946,116,-,Uncharacterized
NEJ1,YLR265C,12,674429,675457,1028,-,Verified
PDR8,YLR266C,12,675621,677726,2105,-,Verified
BOP2,YLR267W,12,678214,679926,1712,+,Uncharacterized
SEC22,YLR268W,12,680202,680846,644,+,Verified
YLR269C,YLR269C,12,680868,681218,350,-,Dubious
DCS1,YLR270W,12,681188,682240,1052,+,Verified
YLR271W,YLR271W,12,682739,683563,824,+,Uncharacterized
YCS4,YLR272C,12,683674,687204,3530,-,Verified
PIG1,YLR273C,12,689085,691031,1946,-,Verified
MCM5,YLR274W,12,691557,693884,2327,+,Verified
SMD2,YLR275W,12,694380,694802,422,+,Verified
DBP9,YLR276C,12,695048,696832,1784,-,Verified
YSH1,YLR277C,12,697158,699497,2339,-,Verified
YLR278C,YLR278C,12,700001,704026,4025,-,Uncharacterized
YLR279W,YLR279W,12,704311,704700,389,+,Dubious
YLR280C,YLR280C,12,704485,704835,350,-,Dubious
YLR281C,YLR281C,12,704495,704962,467,-,Uncharacterized
YLR282C,YLR282C,12,705073,705414,341,-,Dubious
YLR283W,YLR283W,12,705188,706132,944,+,Uncharacterized
ECI1,YLR284C,12,706200,707042,842,-,Verified
NNT1,YLR285W,12,707362,708147,785,+,Verified
YLR285C-A,YLR285C-A,12,708170,708340,170,-,Uncharacterized
CTS1,YLR286C,12,708450,710138,1688,-,Verified
YLR286W-A,YLR286W-A,12,708564,708698,134,+,Dubious
YLR287C,YLR287C,12,710993,712060,1067,-,Uncharacterized
RPS30A,YLR287C-A,12,712539,713160,621,-,Verified
MEC3,YLR288C,12,713482,714906,1424,-,Verified
GUF1,YLR289W,12,715091,717028,1937,+,Verified
YLR290C,YLR290C,12,717147,717980,833,-,Uncharacterized
GCD7,YLR291C,12,718319,719464,1145,-,Verified
SEC72,YLR292C,12,719791,720372,581,-,Verified
GSP1,YLR293C,12,720773,721432,659,-,Verified
YLR294C,YLR294C,12,721703,722032,329,-,Dubious
ATP14,YLR295C,12,722001,722375,374,-,Verified
YLR296W,YLR296W,12,722980,723306,326,+,Dubious
YLR297W,YLR297W,12,724046,724435,389,+,Uncharacterized
YHC1,YLR298C,12,724723,725418,695,-,Verified
ECM38,YLR299W,12,726071,728053,1982,+,Verified
YLR299C-A,YLR299C-A,12,727913,728005,92,-,Dubious
EXG1,YLR300W,12,728957,730303,1346,+,Verified
YLR301W,YLR301W,12,730827,731561,734,+,Uncharacterized
YLR302C,YLR302C,12,732193,732555,362,-,Dubious
MET17,YLR303W,12,732544,733878,1334,+,Verified
ACO1,YLR304C,12,735214,737550,2336,-,Verified
STT4,YLR305C,12,738163,743865,5702,-,Verified
UBC12,YLR306W,12,744153,744853,700,+,Verified
CDA1,YLR307W,12,745622,746527,905,+,Verified
YLR307C-A,YLR307C-A,12,746850,747113,263,-,Uncharacterized
CDA2,YLR308W,12,747939,748877,938,+,Verified
IMH1,YLR309C,12,749036,751771,2735,-,Verified
CDC25,YLR310C,12,752226,756995,4769,-,Verified
YLR311C,YLR311C,12,757267,757614,347,-,Dubious
QNQ1,YLR312C,12,757639,758835,1196,-,Uncharacterized
MRPL15,YLR312W-A,12,759482,760243,761,+,Verified
SPH1,YLR313C,12,760357,762342,1985,-,Verified
CDC3,YLR314C,12,762575,764137,1562,-,Verified
NKP2,YLR315W,12,764808,765269,461,+,Verified
TAD3,YLR316C,12,765266,766358,1092,-,Verified
YLR317W,YLR317W,12,765655,766089,434,+,Dubious
EST2,YLR318W,12,766542,769196,2654,+,Verified
BUD6,YLR319C,12,769318,771684,2366,-,Verified
MMS22,YLR320W,12,771940,776304,4364,+,Verified
SFH1,YLR321C,12,776584,777864,1280,-,Verified
VPS65,YLR322W,12,777628,777942,314,+,Dubious
CWC24,YLR323C,12,778173,778952,779,-,Verified
PEX30,YLR324W,12,779215,780786,1571,+,Verified
RPL38,YLR325C,12,781143,781379,236,-,Verified
YLR326W,YLR326W,12,782174,782896,722,+,Uncharacterized
TMA10,YLR327C,12,783127,783387,260,-,Verified
NMA1,YLR328W,12,784913,786118,1205,+,Verified
REC102,YLR329W,12,786442,787333,891,+,Verified
CHS5,YLR330W,12,787664,789679,2015,+,Verified
JIP3,YLR331C,12,790669,791046,377,-,Dubious
MID2,YLR332W,12,790676,791806,1130,+,Verified
RPS25B,YLR333C,12,795573,796335,762,-,Verified
YLR334C,YLR334C,12,796698,797078,380,-,Dubious
NUP2,YLR335W,12,797430,799592,2162,+,Verified
SGD1,YLR336C,12,799697,802396,2699,-,Verified
VRP1,YLR337C,12,802653,805106,2453,-,Verified
OPI9,YLR338W,12,804346,805203,857,+,Dubious
YLR339C,YLR339C,12,805784,806335,551,-,Dubious
RPP0,YLR340W,12,805887,806825,938,+,Verified
SPO77,YLR341W,12,807385,808818,1433,+,Verified
FKS1,YLR342W,12,809997,815627,5630,+,Verified
YLR342W-A,YLR342W-A,12,815810,815983,173,+,Uncharacterized
GAS2,YLR343W,12,816094,817761,1667,+,Verified
RPL26A,YLR344W,12,819312,820142,830,+,Verified
YLR345W,YLR345W,12,820511,822040,1529,+,Uncharacterized
YLR346C,YLR346C,12,822287,822592,305,-,Uncharacterized
KAP95,YLR347C,12,823827,826412,2585,-,Verified
YLR347W-A,YLR347W-A,12,824788,824928,140,+,Dubious
DIC1,YLR348C,12,826976,827872,896,-,Verified
YLR349W,YLR349W,12,827520,828026,506,+,Dubious
ORM2,YLR350W,12,828729,829379,650,+,Verified
NIT3,YLR351C,12,829488,830363,875,-,Verified
YLR352W,YLR352W,12,831115,833538,2423,+,Uncharacterized
BUD8,YLR353W,12,834351,836162,1811,+,Verified
TAL1,YLR354C,12,836349,837356,1007,-,Verified
ILV5,YLR355C,12,838065,839252,1187,-,Verified
YLR356W,YLR356W,12,840320,840913,593,+,Uncharacterized
RSC2,YLR357W,12,841330,843999,2669,+,Verified
YLR358C,YLR358C,12,843486,844049,563,-,Dubious
ADE13,YLR359W,12,844281,845729,1448,+,Verified
VPS38,YLR360W,12,846102,847421,1319,+,Verified
DCR2,YLR361C,12,847387,849123,1736,-,Verified
YLR361C-A,YLR361C-A,12,849382,849678,296,-,Uncharacterized
STE11,YLR362W,12,849865,852018,2153,+,Verified
NMD4,YLR363C,12,852494,853150,656,-,Verified
YLR363W-A,YLR363W-A,12,853460,853717,257,+,Uncharacterized
GRX8,YLR364W,12,854061,854390,329,+,Uncharacterized
YLR365W,YLR365W,12,855198,855530,332,+,Dubious
YLR364C-A,YLR364C-A,12,855522,855644,122,-,Dubious
YLR366W,YLR366W,12,855537,855842,305,+,Dubious
RPS22B,YLR367W,12,855877,857316,1439,+,Verified
MDM30,YLR368W,12,857539,859335,1796,+,Verified
SSQ1,YLR369W,12,859551,861524,1973,+,Verified
ARC18,YLR370C,12,861717,862253,536,-,Verified
ROM2,YLR371W,12,862713,866783,4070,+,Verified
SUR4,YLR372W,12,867353,868390,1037,+,Verified
VID22,YLR373C,12,868661,871366,2705,-,Verified
YLR374C,YLR374C,12,871452,871841,389,-,Dubious
STP3,YLR375W,12,871696,872727,1031,+,Verified
PSY3,YLR376C,12,872825,873553,728,-,Verified
FBP1,YLR377C,12,873745,874791,1046,-,Verified
SEC61,YLR378C,12,875735,877177,1442,-,Verified
YLR379W,YLR379W,12,876921,877295,374,+,Dubious
CSR1,YLR380W,12,878282,879508,1226,+,Verified
CTF3,YLR381W,12,879723,881924,2201,+,Verified
NAM2,YLR382C,12,882067,884751,2684,-,Verified
SMC6,YLR383W,12,885288,888632,3344,+,Verified
IKI3,YLR384C,12,888851,892900,4049,-,Verified
SWC7,YLR385C,12,892992,893390,398,-,Verified
VAC14,YLR386W,12,893628,896270,2642,+,Verified
REH1,YLR387C,12,896374,897672,1298,-,Verified
RPS29A,YLR388W,12,898158,898821,663,+,Verified
STE23,YLR389C,12,899577,902660,3083,-,Verified
ECM19,YLR390W,12,903066,903404,338,+,Verified
CCW14,YLR390W-A,12,903724,904440,716,+,Verified
YLR392C,YLR392C,12,904749,906305,1556,-,Uncharacterized
ATP10,YLR393W,12,907079,907918,839,+,Verified
CST9,YLR394W,12,907950,909398,1448,+,Verified
COX8,YLR395C,12,909729,909965,236,-,Verified
VPS33,YLR396C,12,910235,912310,2075,-,Verified
AFG2,YLR397C,12,912550,914892,2342,-,Verified
SKI2,YLR398C,12,915156,919019,3863,-,Verified
BDF1,YLR399C,12,919536,921596,2060,-,Verified
YLR399W-A,YLR399W-A,12,920869,920973,104,+,Dubious
YLR400W,YLR400W,12,922063,922536,473,+,Dubious
DUS3,YLR401C,12,922442,924448,2006,-,Verified
YLR402W,YLR402W,12,924564,925079,515,+,Dubious
SFP1,YLR403W,12,925567,927618,2051,+,Verified
FLD1,YLR404W,12,928742,929599,857,+,Verified
DUS4,YLR405W,12,929788,930891,1103,+,Verified
RPL31B,YLR406C,12,931064,931754,690,-,Verified
YLR406C-A,YLR406C-A,12,932205,932354,149,-,Uncharacterized
YLR407W,YLR407W,12,932966,933655,689,+,Uncharacterized
YLR408C,YLR408C,12,933883,934251,368,-,Uncharacterized
UTP21,YLR409C,12,934412,937231,2819,-,Verified
VIP1,YLR410W,12,937539,940979,3440,+,Verified
CTR3,YLR411W,12,947251,947976,725,+,Verified
BER1,YLR412W,12,948366,949190,824,+,Verified
YLR412C-A,YLR412C-A,12,950264,950470,206,-,Uncharacterized
YLR413W,YLR413W,12,951153,953180,2027,+,Uncharacterized
YLR414C,YLR414C,12,953350,954141,791,-,Uncharacterized
YLR415C,YLR415C,12,954256,954594,338,-,Uncharacterized
YLR416C,YLR416C,12,954488,954886,398,-,Dubious
VPS36,YLR417W,12,955007,956707,1700,+,Verified
CDC73,YLR418C,12,956911,958092,1181,-,Verified
YLR419W,YLR419W,12,958425,962732,4307,+,Uncharacterized
URA4,YLR420W,12,963782,964876,1094,+,Verified
RPN13,YLR421C,12,965087,965557,470,-,Verified
YLR422W,YLR422W,12,965894,971692,5798,+,Uncharacterized
ATG17,YLR423C,12,971914,973167,1253,-,Verified
SPP382,YLR424W,12,973392,975518,2126,+,Verified
TUS1,YLR425W,12,982891,986814,3923,+,Verified
YLR426W,YLR426W,12,987059,988110,1051,+,Uncharacterized
MAG2,YLR427W,12,988425,990437,2012,+,Verified
YLR428C,YLR428C,12,990614,990958,344,-,Dubious
CRN1,YLR429W,12,990774,992729,1955,+,Verified
SEN1,YLR430W,12,993431,1000126,6695,+,Verified
ATG23,YLR431C,12,1000339,1001700,1361,-,Verified
IMD3,YLR432W,12,1002554,1004125,1571,+,Verified
CNA1,YLR433C,12,1004344,1006005,1661,-,Verified
YLR434C,YLR434C,12,1006022,1006405,383,-,Dubious
TSR2,YLR435W,12,1006375,1006992,617,+,Verified
ECM30,YLR436C,12,1007418,1011242,3824,-,Verified
YLR437C,YLR437C,12,1011619,1012020,401,-,Uncharacterized
YLR437C-A,YLR437C-A,12,1012456,1012683,227,-,Dubious
CAR2,YLR438W,12,1012498,1013772,1274,+,Verified
LSM3,YLR438C-A,12,1013906,1014175,269,-,Verified
MRPL4,YLR439W,12,1014488,1015447,959,+,Verified
SEC39,YLR440C,12,1015565,1017694,2129,-,Verified
RPS1A,YLR441C,12,1018138,1018905,767,-,Verified
SIR3,YLR442C,12,1019312,1022248,2936,-,Verified
ECM7,YLR443W,12,1022622,1023968,1346,+,Verified
YLR444C,YLR444C,12,1023683,1023985,302,-,Dubious
YLR445W,YLR445W,12,1024186,1024834,648,+,Uncharacterized
YLR446W,YLR446W,12,1025211,1026512,1301,+,Uncharacterized
VMA6,YLR447C,12,1026853,1027890,1037,-,Verified
RPL6B,YLR448W,12,1028850,1029764,914,+,Verified
FPR4,YLR449W,12,1030830,1032008,1178,+,Verified
HMG2,YLR450W,12,1032624,1035761,3137,+,Verified
LEU3,YLR451W,12,1036090,1038750,2660,+,Verified
SST2,YLR452C,12,1039268,1041364,2096,-,Verified
RIF2,YLR453C,12,1041797,1042984,1187,-,Verified
FMP27,YLR454W,12,1043996,1051882,7886,+,Uncharacterized
YLR455W,YLR455W,12,1053627,1054541,914,+,Uncharacterized
YLR456W,YLR456W,12,1055068,1055682,614,+,Uncharacterized
NBP1,YLR457C,12,1055810,1056769,959,-,Verified
YLR458W,YLR458W,12,1056453,1056833,380,+,Dubious
GAB1,YLR459W,12,1057332,1058516,1184,+,Verified
YLR460C,YLR460C,12,1059755,1060885,1130,-,Uncharacterized
PAU4,YLR461W,12,1062917,1063279,362,+,Verified
YLR462W,YLR462W,12,1065954,1066562,608,+,Uncharacterized
YLR463C,YLR463C,12,1066263,1066814,551,-,Dubious
YLR464W,YLR464W,12,1066570,1067499,929,+,Uncharacterized
BSC3,YLR465C,12,1067043,1067351,308,-,Dubious
YRF1-4,YLR466W,12,1067085,1071233,4148,+,Verified
YLR466C-A,YLR466C-A,12,1070385,1070867,482,-,Dubious
YLR466C-B,YLR466C-B,12,1071592,1071708,116,-,Uncharacterized
YRF1-5,YLR467W,12,1072506,1077896,5390,+,Verified
YLR467C-A,YLR467C-A,12,1077048,1077530,482,-,Dubious
YML133C,YML133C,13,461,4684,4223,-,Uncharacterized
YML133W-B,YML133W-B,13,827,1309,482,+,Dubious
YML133W-A,YML133W-A,13,1610,2185,575,+,Dubious
COS3,YML132W,13,7244,8383,1139,+,Verified
YML131W,YML131W,13,10199,11296,1097,+,Uncharacterized
ERO1,YML130C,13,11484,13175,1691,-,Verified
COX14,YML129C,13,14542,14754,212,-,Verified
MSC1,YML128C,13,15136,16677,1541,-,Verified
RSC9,YML127W,13,17065,18810,1745,+,Verified
ERG13,YML126C,13,19061,20536,1475,-,Verified
PGA3,YML125C,13,20762,21700,938,-,Verified
TUB3,YML124C,13,22049,23684,1635,-,Verified
PHO84,YML123C,13,24038,25801,1763,-,Verified
YML122C,YML122C,13,26039,26419,380,-,Dubious
GTR1,YML121W,13,26930,27862,932,+,Verified
NDI1,YML120C,13,28266,29807,1541,-,Verified
YML119W,YML119W,13,30611,31684,1073,+,Uncharacterized
NGL3,YML118W,13,32334,33851,1517,+,Verified
NAB6,YML117W,13,34243,37647,3404,+,Verified
YML116W-A,YML116W-A,13,37472,37774,302,+,Dubious
ATR1,YML116W,13,38196,39824,1628,+,Verified
VAN1,YML115C,13,40187,41794,1607,-,Verified
TAF8,YML114C,13,42043,43575,1532,-,Verified
DAT1,YML113W,13,44045,44791,746,+,Verified
CTK3,YML112W,13,45063,45953,890,+,Verified
BUL2,YML111W,13,46942,49704,2762,+,Verified
COQ5,YML110C,13,50031,50954,923,-,Verified
ZDS2,YML109W,13,51640,54468,2828,+,Verified
YML108W,YML108W,13,54793,55110,317,+,Uncharacterized
PML39,YML107C,13,55265,56269,1004,-,Verified
URA5,YML106W,13,56773,57453,680,+,Verified
SEC65,YML105C,13,57866,58687,821,-,Verified
MDM1,YML104C,13,58939,62322,3383,-,Verified
NUP188,YML103C,13,62582,67549,4967,-,Verified
CAC2,YML102W,13,68294,69700,1406,+,Verified
YML101C-A,YML101C-A,13,69409,69726,317,-,Dubious
CUE4,YML101C,13,69735,70088,353,-,Verified
YML100W-A,YML100W-A,13,70138,70311,173,+,Uncharacterized
TSL1,YML100W,13,70624,73920,3296,+,Verified
YML099W-A,YML099W-A,13,74229,74558,329,+,Dubious
ARG81,YML099C,13,74398,77040,2642,-,Verified
TAF13,YML098W,13,77267,77770,503,+,Verified
VPS9,YML097C,13,78335,79690,1355,-,Verified
YML096W,YML096W,13,79909,81486,1577,+,Uncharacterized
RAD10,YML095C,13,81481,82113,632,-,Verified
YML094C-A,YML094C-A,13,82219,82620,401,-,Dubious
GIM5,YML094W,13,82275,82849,574,+,Verified
UTP14,YML093W,13,83090,85789,2699,+,Verified
PRE8,YML092C,13,85987,86739,752,-,Verified
RPM2,YML091C,13,87123,90731,3608,-,Verified
YML090W,YML090W,13,90744,91130,386,+,Dubious
YML089C,YML089C,13,91041,91409,368,-,Dubious
UFO1,YML088W,13,92235,94241,2006,+,Verified
AIM33,YML087C,13,94431,95369,938,-,Uncharacterized
ALO1,YML086C,13,95791,97371,1580,-,Verified
TUB1,YML085C,13,97941,99400,1459,-,Verified
YML084W,YML084W,13,99489,99797,308,+,Dubious
YML083C,YML083C,13,99794,101050,1256,-,Uncharacterized
YML082W,YML082W,13,101862,103811,1949,+,Uncharacterized
ATP18,YML081C-A,13,103983,104162,179,-,Verified
YML081W,YML081W,13,104777,108532,3755,+,Uncharacterized
DUS1,YML080W,13,108806,110077,1271,+,Verified
YML079W,YML079W,13,110247,110852,605,+,Uncharacterized
CPR3,YML078W,13,111002,111550,548,+,Verified
BET5,YML077W,13,111865,112344,479,+,Verified
WAR1,YML076C,13,112513,115347,2834,-,Verified
HMG1,YML075C,13,115734,118898,3164,-,Verified
FPR3,YML074C,13,120089,121324,1235,-,Verified
RPL6A,YML073C,13,123227,124172,945,-,Verified
TCB3,YML072C,13,124730,129367,4637,-,Verified
COG8,YML071C,13,129749,131572,1823,-,Verified
DAK1,YML070W,13,133475,135229,1754,+,Verified
POB3,YML069W,13,135500,137158,1658,+,Verified
ITT1,YML068W,13,137550,138944,1394,+,Verified
ERV41,YML067C,13,139063,140214,1151,-,Verified
SMA2,YML066C,13,140424,141533,1109,-,Verified
ORC1,YML065W,13,142210,144954,2744,+,Verified
TEM1,YML064C,13,145139,145876,737,-,Verified
RPS1B,YML063W,13,146482,147249,767,+,Verified
MFT1,YML062C,13,147505,148683,1178,-,Verified
PIF1,YML061C,13,148953,151532,2579,-,Verified
OGG1,YML060W,13,151871,153001,1130,+,Verified
NTE1,YML059C,13,153219,158258,5039,-,Verified
HUG1,YML058W-A,13,158760,158966,206,+,Verified
SML1,YML058W,13,159383,159697,314,+,Verified
YML057C-A,YML057C-A,13,160023,160412,389,-,Dubious
CMP2,YML057W,13,160180,161994,1814,+,Verified
IMD4,YML056C,13,162194,164176,1982,-,Verified
SPC2,YML055W,13,164790,165326,536,+,Verified
CYB2,YML054C,13,165533,167308,1775,-,Verified
YML054C-A,YML054C-A,13,167623,167781,158,-,Uncharacterized
YML053C,YML053C,13,169116,169754,638,-,Uncharacterized
SUR7,YML052W,13,170402,171310,908,+,Verified
GAL80,YML051W,13,171594,172901,1307,+,Verified
AIM32,YML050W,13,173139,174074,935,+,Uncharacterized
RSE1,YML049C,13,174220,178305,4085,-,Verified
GSF2,YML048W,13,178426,179637,1211,+,Verified
YML047W-A,YML047W-A,13,179893,180258,365,+,Dubious
PRM6,YML047C,13,180017,181075,1058,-,Verified
PRP39,YML046W,13,181474,183363,1889,+,Verified
RRN11,YML043C,13,190244,191767,1523,-,Verified
CAT2,YML042W,13,192788,194800,2012,+,Verified
VPS71,YML041C,13,194913,195755,842,-,Verified
YMD8,YML038C,13,202775,204103,1328,-,Verified
YML037C,YML037C,13,204386,205408,1022,-,Uncharacterized
CGI121,YML036W,13,205642,206293,651,+,Verified
AMD1,YML035C,13,206428,208860,2432,-,Verified
YML034C-A,YML034C-A,13,209428,209826,398,-,Dubious
SRC1,YML034W,13,209525,212155,2630,+,Verified
RAD52,YML032C,13,212515,213930,1415,-,Verified
YML031C-A,YML031C-A,13,214086,214421,335,-,Dubious
NDC1,YML031W,13,214189,216156,1967,+,Verified
AIM31,YML030W,13,216435,216914,479,+,Uncharacterized
USA1,YML029W,13,217362,219878,2516,+,Verified
TSA1,YML028W,13,220138,220728,590,+,Verified
YOX1,YML027W,13,221406,222563,1157,+,Verified
RPS18B,YML026C,13,222987,223828,841,-,Verified
YML6,YML025C,13,224406,225365,959,-,Verified
RPS17A,YML024W,13,225889,226697,808,+,Verified
NSE5,YML023C,13,226994,228664,1670,-,Verified
APT1,YML022W,13,228937,229500,563,+,Verified
UNG1,YML021C,13,229734,230813,1079,-,Verified
YML020W,YML020W,13,231149,233143,1994,+,Uncharacterized
OST6,YML019W,13,233457,234455,998,+,Verified
YML018C,YML018C,13,234771,235952,1181,-,Uncharacterized
PSP2,YML017W,13,236588,238731,2143,+,Verified
PPZ1,YML016C,13,239458,241536,2078,-,Verified
TAF11,YML015C,13,241989,243029,1040,-,Verified
TRM9,YML014W,13,243225,244064,839,+,Verified
UBX2,YML013W,13,244149,245903,1754,+,Verified
YML012C-A,YML012C-A,13,245537,245914,377,-,Dubious
ERV25,YML012W,13,246116,246751,635,+,Verified
RAD33,YML011C,13,246895,247428,533,-,Verified
SPT5,YML010W,13,247677,250868,3191,+,Verified
YML009W-B,YML009W-B,13,250435,250911,476,+,Dubious
YML009C-A,YML009C-A,13,250675,251001,326,-,Dubious
MRPL39,YML009C,13,251304,251516,212,-,Verified
ERG6,YML008C,13,251839,252990,1151,-,Verified
YML007C-A,YML007C-A,13,253162,253272,110,-,Uncharacterized
YAP1,YML007W,13,253848,255800,1952,+,Verified
GIS4,YML006C,13,256092,258416,2324,-,Verified
TRM12,YML005W,13,260221,261609,1388,+,Verified
GLO1,YML004C,13,261705,262685,980,-,Verified
YML003W,YML003W,13,263483,264355,872,+,Uncharacterized
YML002W,YML002W,13,264541,266754,2213,+,Uncharacterized
YPT7,YML001W,13,267174,267800,626,+,Verified
CDC5,YMR001C,13,269019,271136,2117,-,Verified
YMR001C-A,YMR001C-A,13,271347,271577,230,-,Uncharacterized
MIC17,YMR002W,13,272193,272663,470,+,Verified
AIM34,YMR003W,13,273118,273714,596,+,Uncharacterized
MVP1,YMR004W,13,274017,275552,1535,+,Verified
TAF4,YMR005W,13,276045,277211,1166,+,Verified
PLB2,YMR006C,13,277561,279681,2120,-,Verified
YMR007W,YMR007W,13,279960,280340,380,+,Dubious
PLB1,YMR008C,13,280590,282584,1994,-,Verified
ADI1,YMR009W,13,284101,284640,539,+,Verified
YMR010W,YMR010W,13,285099,286316,1217,+,Uncharacterized
HXT2,YMR011W,13,288078,289703,1625,+,Verified
CLU1,YMR012W,13,291133,294966,3833,+,Verified
SEC59,YMR013C,13,295178,296737,1559,-,Verified
YMR013C-A,YMR013C-A,13,296470,296619,149,-,Dubious
YMR013W-A,YMR013W-A,13,298310,298390,80,+,Dubious
BUD22,YMR014W,13,298867,300426,1559,+,Verified
ERG5,YMR015C,13,300868,302484,1616,-,Verified
SOK2,YMR016C,13,303235,305592,2357,-,Verified
SPO20,YMR017W,13,307488,308681,1193,+,Verified
YMR018W,YMR018W,13,310207,311751,1544,+,Uncharacterized
STB4,YMR019W,13,312155,315004,2849,+,Verified
FMS1,YMR020W,13,315376,316902,1526,+,Verified
MAC1,YMR021C,13,317164,318417,1253,-,Verified
UBC7,YMR022W,13,318679,319176,497,+,Verified
MSS1,YMR023C,13,319436,321016,1580,-,Verified
MRPL3,YMR024W,13,321874,323046,1172,+,Verified
CSI1,YMR025W,13,323299,324186,887,+,Verified
PEX12,YMR026C,13,324235,325434,1199,-,Verified
YMR027W,YMR027W,13,325876,327288,1412,+,Uncharacterized
TAP42,YMR028W,13,327481,328581,1100,+,Verified
FAR8,YMR029C,13,328659,330230,1571,-,Verified
RSF1,YMR030W,13,330792,331922,1130,+,Verified
YMR031C,YMR031C,13,332211,334742,2531,-,Uncharacterized
YMR031W-A,YMR031W-A,13,334708,335034,326,+,Dubious
HOF1,YMR032W,13,335297,337306,2009,+,Verified
YMR030W-A,YMR030W-A,13,337312,337602,290,+,Uncharacterized
ARP9,YMR033W,13,337787,339276,1489,+,Verified
YMR034C,YMR034C,13,339417,340721,1304,-,Uncharacterized
IMP2,YMR035W,13,341141,341674,533,+,Verified
MIH1,YMR036C,13,341855,343519,1664,-,Verified
MSN2,YMR037C,13,344402,346516,2114,-,Verified
CCS1,YMR038C,13,347510,348259,749,-,Verified
SUB1,YMR039C,13,348643,349521,878,-,Verified
YET2,YMR040W,13,350380,350862,482,+,Verified
ARA2,YMR041C,13,350965,351972,1007,-,Verified
ARG80,YMR042W,13,352602,353135,533,+,Verified
MCM1,YMR043W,13,353870,354730,860,+,Verified
IOC4,YMR044W,13,355383,356810,1427,+,Verified
YMR046W-A,YMR046W-A,13,362701,362829,128,+,Dubious
NUP116,YMR047C,13,363363,366704,3341,-,Verified
CSM3,YMR048W,13,366980,367933,953,+,Verified
ERB1,YMR049C,13,368093,370516,2423,-,Verified
FAR3,YMR052W,13,379585,380199,614,+,Verified
YMR052C-A,YMR052C-A,13,380068,380433,365,-,Dubious
STB2,YMR053C,13,380345,382897,2552,-,Verified
STV1,YMR054W,13,383302,385974,2672,+,Verified
BUB2,YMR055C,13,386100,387020,920,-,Verified
AAC1,YMR056C,13,387314,388243,929,-,Verified
YMR057C,YMR057C,13,388358,388729,371,-,Dubious
FET3,YMR058W,13,388821,390731,1910,+,Verified
SEN15,YMR059W,13,391098,391484,386,+,Verified
SAM37,YMR060C,13,391531,392514,983,-,Verified
RNA14,YMR061W,13,392754,394787,2033,+,Verified
ECM40,YMR062C,13,395053,396378,1325,-,Verified
RIM9,YMR063W,13,397076,397795,719,+,Verified
AEP1,YMR064W,13,397902,399458,1556,+,Verified
KAR5,YMR065W,13,399701,401215,1514,+,Verified
SOV1,YMR066W,13,401540,404236,2696,+,Verified
UBX4,YMR067C,13,404322,405572,1250,-,Verified
AVO2,YMR068W,13,406303,407583,1280,+,Verified
NAT4,YMR069W,13,407708,408565,857,+,Verified
MOT3,YMR070W,13,409153,410625,1472,+,Verified
TVP18,YMR071C,13,410761,411264,503,-,Verified
ABF2,YMR072W,13,411568,412119,551,+,Verified
IRC21,YMR073C,13,412267,412872,605,-,Verified
YMR074C,YMR074C,13,413035,413472,437,-,Uncharacterized
RCO1,YMR075W,13,413981,416035,2054,+,Verified
YMR075C-A,YMR075C-A,13,415687,416052,365,-,Dubious
PDS5,YMR076C,13,416195,420028,3833,-,Verified
VPS20,YMR077C,13,421483,422148,665,-,Verified
CTF18,YMR078C,13,422502,424727,2225,-,Verified
SEC14,YMR079W,13,424988,426058,1070,+,Verified
NAM7,YMR080C,13,426711,429626,2915,-,Verified
ISF1,YMR081C,13,430078,431094,1016,-,Verified
YMR082C,YMR082C,13,431768,432124,356,-,Dubious
ADH3,YMR083W,13,434787,435914,1127,+,Verified
YMR084W,YMR084W,13,436627,437415,788,+,Uncharacterized
YMR085W,YMR085W,13,437490,438788,1298,+,Uncharacterized
YMR086W,YMR086W,13,439207,442089,2882,+,Verified
YMR086C-A,YMR086C-A,13,442025,442363,338,-,Dubious
YMR087W,YMR087W,13,442526,443380,854,+,Verified
VBA1,YMR088C,13,443413,445101,1688,-,Verified
YTA12,YMR089C,13,445608,448085,2477,-,Verified
YMR090W,YMR090W,13,449244,449927,683,+,Uncharacterized
NPL6,YMR091C,13,450057,451364,1307,-,Verified
AIP1,YMR092C,13,451631,453478,1847,-,Verified
UTP15,YMR093W,13,454014,455555,1541,+,Verified
CTF13,YMR094W,13,455824,457260,1436,+,Verified
SNO1,YMR095C,13,457284,457958,674,-,Verified
SNZ1,YMR096W,13,458407,459300,893,+,Verified
MTG1,YMR097C,13,459423,460526,1103,-,Verified
ATP25,YMR098C,13,460770,462608,1838,-,Verified
YMR099C,YMR099C,13,463933,464826,893,-,Verified
MUB1,YMR100W,13,466299,468161,1862,+,Verified
SRT1,YMR101C,13,468444,469475,1031,-,Verified
YMR102C,YMR102C,13,469847,472351,2504,-,Uncharacterized
YMR103C,YMR103C,13,472901,473263,362,-,Dubious
YPK2,YMR104C,13,473419,475452,2033,-,Verified
PGM2,YMR105C,13,475896,477605,1709,-,Verified
YMR105W-A,YMR105W-A,13,478063,478257,194,+,Uncharacterized
YKU80,YMR106C,13,478300,480189,1889,-,Verified
SPG4,YMR107W,13,483013,483360,347,+,Verified
ILV2,YMR108W,13,484083,486146,2063,+,Verified
MYO5,YMR109W,13,486586,490245,3659,+,Verified
HFD1,YMR110C,13,490393,491991,1598,-,Verified
YMR111C,YMR111C,13,492403,493791,1388,-,Uncharacterized
MED11,YMR112C,13,494099,494494,395,-,Verified
FOL3,YMR113W,13,494998,496281,1283,+,Verified
YMR114C,YMR114C,13,496342,497448,1106,-,Verified
FMP24,YMR115W,13,497703,499208,1505,+,Uncharacterized
ASC1,YMR116C,13,499455,500687,1232,-,Verified
SPC24,YMR117C,13,501249,501890,641,-,Verified
YMR118C,YMR118C,13,502143,502733,590,-,Uncharacterized
ASI1,YMR119W,13,505332,507206,1874,+,Verified
YMR119W-A,YMR119W-A,13,506995,507369,374,+,Dubious
ADE17,YMR120C,13,507501,509279,1778,-,Verified
RPL15B,YMR121C,13,509733,510347,614,-,Verified
YMR122C,YMR122C,13,510700,511074,374,-,Dubious
YMR122W-A,YMR122W-A,13,511314,511568,254,+,Uncharacterized
PKR1,YMR123W,13,513592,513960,368,+,Verified
YMR124W,YMR124W,13,514455,517286,2831,+,Uncharacterized
STO1,YMR125W,13,517538,520445,2907,+,Verified
DLT1,YMR126C,13,520760,521788,1028,-,Uncharacterized
SAS2,YMR127C,13,522328,523344,1016,-,Verified
ECM16,YMR128W,13,523695,527498,3803,+,Verified
POM152,YMR129W,13,527803,531816,4013,+,Verified
YMR130W,YMR130W,13,532118,533026,908,+,Uncharacterized
RRB1,YMR131C,13,533162,534697,1535,-,Verified
JLP2,YMR132C,13,534943,535569,626,-,Uncharacterized
REC114,YMR133W,13,536206,537608,1402,+,Verified
ERG29,YMR134W,13,537837,538550,713,+,Uncharacterized
GID8,YMR135C,13,538688,540055,1367,-,Verified
YMR135W-A,YMR135W-A,13,539910,540443,533,+,Dubious
GAT2,YMR136W,13,541198,542880,1682,+,Verified
PSO2,YMR137C,13,542977,544962,1985,-,Verified
CIN4,YMR138W,13,545154,545729,575,+,Verified
RIM11,YMR139W,13,546124,547236,1112,+,Verified
SIP5,YMR140W,13,547713,549182,1469,+,Verified
YMR141C,YMR141C,13,549735,550043,308,-,Dubious
RPL13B,YMR142C,13,550205,551206,1001,-,Verified
YMR141W-A,YMR141W-A,13,550910,551134,224,+,Dubious
RPS16A,YMR143W,13,551927,552902,975,+,Verified
YMR144W,YMR144W,13,553361,554389,1028,+,Uncharacterized
NDE1,YMR145C,13,554792,556474,1682,-,Verified
TIF34,YMR146C,13,557480,558523,1043,-,Verified
YMR147W,YMR147W,13,559198,559869,671,+,Uncharacterized
YMR148W,YMR148W,13,560365,560811,446,+,Uncharacterized
SWP1,YMR149W,13,560995,561855,860,+,Verified
IMP1,YMR150C,13,561955,562527,572,-,Verified
YIM2,YMR151W,13,562505,562942,437,+,Dubious
YIM1,YMR152W,13,563095,564192,1097,+,Verified
NUP53,YMR153W,13,564434,565861,1427,+,Verified
YMR153C-A,YMR153C-A,13,565573,565908,335,-,Dubious
RIM13,YMR154C,13,565998,568181,2183,-,Verified
YMR155W,YMR155W,13,568550,570193,1643,+,Uncharacterized
TPP1,YMR156C,13,570299,571015,716,-,Verified
AIM36,YMR157C,13,571276,572043,767,-,Uncharacterized
MRPS8,YMR158W,13,572247,572714,467,+,Verified
YMR158C-A,YMR158C-A,13,573193,573330,137,-,Uncharacterized
YMR158W-B,YMR158W-B,13,574470,574790,320,+,Dubious
ATG16,YMR159C,13,574475,574927,452,-,Verified
YMR160W,YMR160W,13,575065,577515,2450,+,Uncharacterized
HLJ1,YMR161W,13,577717,578391,674,+,Verified
DNF3,YMR162C,13,578950,583920,4970,-,Verified
INP2,YMR163C,13,584270,586387,2117,-,Verified
MSS11,YMR164C,13,587273,589549,2276,-,Verified
PAH1,YMR165C,13,590039,592627,2588,-,Verified
YMR166C,YMR166C,13,593366,594472,1106,-,Uncharacterized
MLH1,YMR167W,13,594885,597194,2309,+,Verified
CEP3,YMR168C,13,597331,599157,1826,-,Verified
ALD3,YMR169C,13,599351,600871,1520,-,Verified
ALD2,YMR170C,13,601561,603081,1520,-,Verified
EAR1,YMR171C,13,603867,605519,1652,-,Verified
HOT1,YMR172W,13,605980,608139,2159,+,Verified
YMR172C-A,YMR172C-A,13,607827,608210,383,-,Dubious
DDR48,YMR173W,13,608688,609980,1292,+,Verified
YMR173W-A,YMR173W-A,13,608896,610080,1184,+,Dubious
PAI3,YMR174C,13,610158,610364,206,-,Verified
SIP18,YMR175W,13,611015,611254,239,+,Verified
YMR175W-A,YMR175W-A,13,611313,611507,194,+,Uncharacterized
ECM5,YMR176W,13,611739,615974,4235,+,Verified
MMT1,YMR177W,13,616565,618097,1532,+,Verified
YMR178W,YMR178W,13,618478,619302,824,+,Uncharacterized
SPT21,YMR179W,13,619857,622133,2276,+,Verified
CTL1,YMR180C,13,622250,623212,962,-,Verified
YMR181C,YMR181C,13,623615,624079,464,-,Uncharacterized
RGM1,YMR182C,13,624531,625166,635,-,Verified
YMR182W-A,YMR182W-A,13,625810,625896,86,+,Uncharacterized
SSO2,YMR183C,13,626920,627807,887,-,Verified
ADD37,YMR184W,13,628188,628784,596,+,Verified
YMR185W,YMR185W,13,629024,631969,2945,+,Uncharacterized
HSC82,YMR186W,13,632354,634471,2117,+,Verified
YMR187C,YMR187C,13,634688,635983,1295,-,Uncharacterized
MRPS17,YMR188C,13,636290,637003,713,-,Verified
GCV2,YMR189W,13,637499,640603,3104,+,Verified
SGS1,YMR190C,13,640914,645257,4343,-,Verified
SPG5,YMR191W,13,645655,646776,1121,+,Verified
GYL1,YMR192W,13,647117,649279,2162,+,Verified
MRPL24,YMR193W,13,650035,650811,776,+,Verified
YMR193C-A,YMR193C-A,13,651071,651457,386,-,Dubious
RPL36A,YMR194W,13,651144,651909,765,+,Verified
YMR194C-B,YMR194C-B,13,652593,652886,293,-,Uncharacterized
YMR194C-A,YMR194C-A,13,652911,653135,224,-,Dubious
ICY1,YMR195W,13,654033,654416,383,+,Verified
YMR196W,YMR196W,13,655075,658341,3266,+,Uncharacterized
VTI1,YMR197C,13,658544,659197,653,-,Verified
CIK1,YMR198W,13,659744,661528,1784,+,Verified
CLN1,YMR199W,13,662643,664283,1640,+,Verified
ROT1,YMR200W,13,664751,665521,770,+,Verified
RAD14,YMR201C,13,665844,667043,1199,-,Verified
ERG2,YMR202W,13,667536,668204,668,+,Verified
TOM40,YMR203W,13,668491,669654,1163,+,Verified
INP1,YMR204C,13,670062,671324,1262,-,Verified
PFK2,YMR205C,13,671886,674765,2879,-,Verified
YMR206W,YMR206W,13,675895,676836,941,+,Uncharacterized
HFA1,YMR207C,13,677192,683563,6371,-,Verified
ERG12,YMR208W,13,684466,685797,1331,+,Verified
YMR209C,YMR209C,13,685910,687283,1373,-,Uncharacterized
YMR210W,YMR210W,13,687515,688864,1349,+,Verified
DML1,YMR211W,13,689082,690509,1427,+,Verified
EFR3,YMR212C,13,690694,693042,2348,-,Verified
CEF1,YMR213W,13,693380,695152,1772,+,Verified
SCJ1,YMR214W,13,695349,696482,1133,+,Verified
GAS3,YMR215W,13,696795,698369,1574,+,Verified
SKY1,YMR216C,13,698810,701038,2228,-,Verified
GUA1,YMR217W,13,701789,703366,1577,+,Verified
TRS130,YMR218C,13,703578,706886,3308,-,Verified
ESC1,YMR219W,13,707132,712108,4976,+,Verified
ERG8,YMR220W,13,712315,713670,1355,+,Verified
FMP42,YMR221C,13,713930,715444,1514,-,Uncharacterized
FSH2,YMR222C,13,715637,716308,671,-,Verified
UBP8,YMR223W,13,716714,718129,1415,+,Verified
MRE11,YMR224C,13,718574,720652,2078,-,Verified
MRPL44,YMR225C,13,720959,721402,443,-,Verified
TMA29,YMR226C,13,721592,722395,803,-,Verified
TAF7,YMR227C,13,722612,724384,1772,-,Verified
MTF1,YMR228W,13,724625,725650,1025,+,Verified
RRP5,YMR229C,13,725933,731122,5189,-,Verified
RPS10B,YMR230W,13,732413,733140,727,+,Verified
YMR230W-A,YMR230W-A,13,733267,733455,188,+,Uncharacterized
PEP5,YMR231W,13,733544,736633,3089,+,Verified
FUS2,YMR232W,13,736925,738958,2033,+,Verified
TRI1,YMR233W,13,739184,739864,680,+,Verified
RNH1,YMR234W,13,740265,741311,1046,+,Verified
RNA1,YMR235C,13,741511,742734,1223,-,Verified
TAF9,YMR236W,13,742970,743443,473,+,Verified
BCH1,YMR237W,13,743748,745922,2174,+,Verified
DFG5,YMR238W,13,746352,747728,1376,+,Verified
RNT1,YMR239C,13,748261,749676,1415,-,Verified
CUS1,YMR240C,13,749929,751239,1310,-,Verified
YHM2,YMR241W,13,751960,752904,944,+,Verified
RPL20A,YMR242C,13,753224,754219,995,-,Verified
YMR242W-A,YMR242W-A,13,754296,754385,89,+,Uncharacterized
ZRC1,YMR243C,13,754837,756165,1328,-,Verified
YMR244W,YMR244W,13,757249,758316,1067,+,Uncharacterized
YMR244C-A,YMR244C-A,13,758516,758830,314,-,Uncharacterized
YMR245W,YMR245W,13,758562,759182,620,+,Dubious
FAA4,YMR246W,13,759806,761890,2084,+,Verified
RKR1,YMR247C,13,763350,768038,4688,-,Verified
YMR247W-A,YMR247W-A,13,769282,769425,143,+,Uncharacterized
GAD1,YMR250W,13,770800,772557,1757,+,Verified
GTO3,YMR251W,13,772914,774014,1100,+,Verified
HOR7,YMR251W-A,13,774751,774930,179,+,Verified
YMR252C,YMR252C,13,775314,775718,404,-,Uncharacterized
YMR253C,YMR253C,13,775945,777189,1244,-,Uncharacterized
YMR254C,YMR254C,13,777614,777922,308,-,Dubious
GFD1,YMR255W,13,778000,778566,566,+,Verified
COX7,YMR256C,13,778944,779126,182,-,Verified
PET111,YMR257C,13,779628,782030,2402,-,Verified
YMR258C,YMR258C,13,782619,784280,1661,-,Uncharacterized
YMR259C,YMR259C,13,784620,788882,4262,-,Uncharacterized
TIF11,YMR260C,13,789377,789838,461,-,Verified
TPS3,YMR261C,13,790204,793368,3164,-,Verified
YMR262W,YMR262W,13,793725,794666,941,+,Uncharacterized
SAP30,YMR263W,13,794918,795523,605,+,Verified
CUE1,YMR264W,13,795804,796415,611,+,Verified
YMR265C,YMR265C,13,796539,797924,1385,-,Uncharacterized
RSN1,YMR266W,13,798517,801378,2861,+,Verified
PPA2,YMR267W,13,801771,802703,932,+,Verified
PRP24,YMR268C,13,802887,804221,1334,-,Verified
TMA23,YMR269W,13,804455,805090,635,+,Verified
RRN9,YMR270C,13,805325,806422,1097,-,Verified
URA10,YMR271C,13,806864,807547,683,-,Verified
SCS7,YMR272C,13,809622,810776,1154,-,Verified
YMR272W-A,YMR272W-A,13,810465,810578,113,+,Dubious
YMR272W-B,YMR272W-B,13,811088,811195,107,+,Uncharacterized
ZDS1,YMR273C,13,811232,813979,2747,-,Verified
RCE1,YMR274C,13,814363,815310,947,-,Verified
BUL1,YMR275C,13,815650,818580,2930,-,Verified
DSK2,YMR276W,13,818826,819947,1121,+,Verified
FCP1,YMR277W,13,820255,822453,2198,+,Verified
PGM3,YMR278W,13,822762,824630,1868,+,Verified
YMR279C,YMR279C,13,824728,826350,1622,-,Uncharacterized
CAT8,YMR280C,13,827027,831328,4301,-,Verified
GPI12,YMR281W,13,832338,833252,914,+,Verified
AEP2,YMR282C,13,833355,835097,1742,-,Verified
RIT1,YMR283C,13,835325,836866,1541,-,Verified
YKU70,YMR284W,13,838186,839994,1808,+,Verified
NGL2,YMR285C,13,840143,841690,1547,-,Verified
MRPL33,YMR286W,13,841941,842201,260,+,Verified
DSS1,YMR287C,13,842435,845344,2909,-,Verified
HSH155,YMR288W,13,845570,848485,2915,+,Verified
ABZ2,YMR289W,13,848684,849808,1124,+,Verified
HAS1,YMR290C,13,850073,851590,1517,-,Verified
YMR290W-A,YMR290W-A,13,851421,851768,347,+,Dubious
YMR291W,YMR291W,13,852629,854389,1760,+,Uncharacterized
GOT1,YMR292W,13,854794,855292,498,+,Verified
LRC6,YMR293C,13,855398,856792,1394,-,Uncharacterized
JNM1,YMR294W,13,856965,858086,1121,+,Verified
YMR294W-A,YMR294W-A,13,858208,858567,359,+,Dubious
YMR295C,YMR295C,13,858296,858889,593,-,Verified
LCB1,YMR296C,13,859214,860890,1676,-,Verified
PRC1,YMR297W,13,861921,863519,1598,+,Verified
LIP1,YMR298W,13,863818,864270,452,+,Verified
DYN3,YMR299C,13,864411,865349,938,-,Verified
ADE4,YMR300C,13,865558,867090,1532,-,Verified
ATM1,YMR301C,13,867554,869626,2072,-,Verified
YME2,YMR302C,13,870072,872624,2552,-,Verified
ADH2,YMR303C,13,873290,874336,1046,-,Verified
UBP15,YMR304W,13,874986,878678,3692,+,Verified
YMR304C-A,YMR304C-A,13,878779,879129,350,-,Dubious
SCW10,YMR305C,13,879062,880231,1169,-,Verified
FKS3,YMR306W,13,881158,886515,5357,+,Verified
YMR306C-A,YMR306C-A,13,886182,886571,389,-,Dubious
GAS1,YMR307W,13,887002,888681,1679,+,Verified
YMR307C-A,YMR307C-A,13,887730,887924,194,-,Dubious
PSE1,YMR308C,13,888951,892220,3269,-,Verified
NIP1,YMR309C,13,892987,895425,2438,-,Verified
YMR310C,YMR310C,13,895715,896668,953,-,Uncharacterized
GLC8,YMR311C,13,896913,897602,689,-,Verified
ELP6,YMR312W,13,898404,899225,821,+,Verified
TGL3,YMR313C,13,899378,901306,1928,-,Verified
PRE5,YMR314W,13,901708,902412,704,+,Verified
YMR315W,YMR315W,13,902799,903848,1049,+,Uncharacterized
YMR315W-A,YMR315W-A,13,904285,904392,107,+,Uncharacterized
DIA1,YMR316W,13,904823,905833,1010,+,Verified
YMR316C-A,YMR316C-A,13,905660,905971,311,-,Dubious
YMR316C-B,YMR316C-B,13,907319,907627,308,-,Dubious
YMR317W,YMR317W,13,907362,910784,3422,+,Uncharacterized
ADH6,YMR318C,13,911059,912141,1082,-,Verified
FET4,YMR319C,13,912878,914536,1658,-,Verified
YMR320W,YMR320W,13,916744,917049,305,+,Dubious
YMR321C,YMR321C,13,917577,917894,317,-,Uncharacterized
SNO4,YMR322C,13,918364,919077,713,-,Uncharacterized
ERR3,YMR323W,13,920086,921399,1313,+,Verified
YMR324C,YMR324C,13,922200,922442,242,-,Dubious
PAU19,YMR325W,13,922639,923013,374,+,Uncharacterized
YMR326C,YMR326C,13,923492,923800,308,-,Dubious
YRF1-6,YNL339C,14,371,6098,5727,-,Verified
YNL339W-B,YNL339W-B,14,734,1216,482,+,Dubious
YNL339W-A,YNL339W-A,14,1517,2092,575,+,Dubious
YNL338W,YNL338W,14,6561,6719,158,+,Dubious
YNL337W,YNL337W,14,7165,7419,254,+,Dubious
COS1,YNL336W,14,8330,9475,1145,+,Verified
DDI3,YNL335W,14,11452,12129,677,+,Uncharacterized
SNO2,YNL334C,14,12208,12876,668,-,Verified
SNZ2,YNL333W,14,13267,14163,896,+,Verified
THI12,YNL332W,14,14832,15854,1022,+,Verified
AAD14,YNL331C,14,16118,17248,1130,-,Verified
RPD3,YNL330C,14,18001,19302,1301,-,Verified
PEX6,YNL329C,14,19541,22633,3092,-,Verified
MDJ2,YNL328C,14,22834,23274,440,-,Verified
EGT2,YNL327W,14,24047,27172,3125,+,Verified
PFA3,YNL326C,14,27336,28346,1010,-,Verified
FIG4,YNL325C,14,28738,31377,2639,-,Verified
YNL324W,YNL324W,14,31049,31444,395,+,Dubious
LEM3,YNL323W,14,31943,33187,1244,+,Verified
KRE1,YNL322C,14,33293,34234,941,-,Verified
VNX1,YNL321W,14,34695,37421,2726,+,Verified
YNL320W,YNL320W,14,37699,38553,854,+,Uncharacterized
YNL319W,YNL319W,14,38641,39081,440,+,Dubious
HXT14,YNL318C,14,38706,40328,1622,-,Verified
PFS2,YNL317W,14,40618,42015,1397,+,Verified
PHA2,YNL316C,14,42070,43074,1004,-,Verified
ATP11,YNL315C,14,43323,44279,956,-,Verified
DAL82,YNL314W,14,44446,45213,767,+,Verified
YNL313C,YNL313C,14,45307,48021,2714,-,Uncharacterized
RFA2,YNL312W,14,48286,49215,929,+,Verified
YNL311C,YNL311C,14,49396,51687,2291,-,Verified
ZIM17,YNL310C,14,51906,52430,524,-,Verified
STB1,YNL309W,14,52661,53923,1262,+,Verified
KRI1,YNL308C,14,54121,55896,1775,-,Verified
MCK1,YNL307C,14,56446,57573,1127,-,Verified
MRPS18,YNL306W,14,58155,58808,653,+,Verified
YNL305C,YNL305C,14,58898,59791,893,-,Uncharacterized
YPT11,YNL304W,14,60297,61550,1253,+,Verified
YNL303W,YNL303W,14,61510,61857,347,+,Dubious
RPS19B,YNL302C,14,61958,62943,985,-,Verified
RPL18B,YNL301C,14,63570,64562,992,-,Verified
YNL300W,YNL300W,14,65744,66052,308,+,Uncharacterized
TRF5,YNL299W,14,66517,68445,1928,+,Verified
CLA4,YNL298W,14,68915,71443,2528,+,Verified
MON2,YNL297C,14,71673,76583,4910,-,Verified
YNL296W,YNL296W,14,76273,76587,314,+,Dubious
YNL295W,YNL295W,14,76946,78520,1574,+,Uncharacterized
RIM21,YNL294C,14,78659,80260,1601,-,Verified
MSB3,YNL293W,14,80640,82541,1901,+,Verified
PUS4,YNL292W,14,82806,84017,1211,+,Verified
MID1,YNL291C,14,84169,85815,1646,-,Verified
RFC3,YNL290W,14,86218,87240,1022,+,Verified
PCL1,YNL289W,14,87897,88736,839,+,Verified
CAF40,YNL288W,14,90303,91424,1121,+,Verified
SEC21,YNL287W,14,91994,94801,2807,+,Verified
CUS2,YNL286W,14,95223,96080,857,+,Verified
YNL285W,YNL285W,14,96173,96544,371,+,Dubious
MRPL10,YNL284C,14,103134,104102,968,-,Verified
WSC2,YNL283C,14,105184,106695,1511,-,Verified
POP3,YNL282W,14,107687,108274,587,+,Verified
HCH1,YNL281W,14,108467,108928,461,+,Verified
ERG24,YNL280C,14,109095,110411,1316,-,Verified
PRM1,YNL279W,14,110917,112902,1985,+,Verified
CAF120,YNL278W,14,113271,116453,3182,+,Verified
YNL277W-A,YNL277W-A,14,116679,116867,188,+,Uncharacterized
MET2,YNL277W,14,117349,118809,1460,+,Verified
YNL276C,YNL276C,14,118431,118826,395,-,Dubious
BOR1,YNL275W,14,119268,120998,1730,+,Verified
GOR1,YNL274C,14,121118,122170,1052,-,Verified
TOF1,YNL273W,14,122883,126599,3716,+,Verified
SEC2,YNL272C,14,126805,129084,2279,-,Verified
BNI1,YNL271C,14,129523,135384,5861,-,Verified
ALP1,YNL270C,14,135941,137662,1721,-,Verified
BSC4,YNL269W,14,137700,138095,395,+,Verified
LYP1,YNL268W,14,138551,140386,1835,+,Verified
PIK1,YNL267W,14,140879,144079,3200,+,Verified
YNL266W,YNL266W,14,144246,144665,419,+,Dubious
IST1,YNL265C,14,144281,145282,1001,-,Verified
PDR17,YNL264C,14,145564,146616,1052,-,Verified
YIF1,YNL263C,14,146897,147841,944,-,Verified
POL2,YNL262W,14,148213,154881,6668,+,Verified
ORC5,YNL261W,14,155101,156540,1439,+,Verified
YNL260C,YNL260C,14,156860,157456,596,-,Uncharacterized
ATX1,YNL259C,14,157645,157866,221,-,Verified
DSL1,YNL258C,14,158110,160374,2264,-,Verified
SIP3,YNL257C,14,160632,164321,3689,-,Verified
FOL1,YNL256W,14,164624,167098,2474,+,Verified
GIS2,YNL255C,14,167330,167791,461,-,Verified
RTC4,YNL254C,14,168044,169249,1205,-,Uncharacterized
TEX1,YNL253W,14,170019,171287,1268,+,Verified
MRPL17,YNL252C,14,171442,172287,845,-,Verified
NRD1,YNL251C,14,172589,174316,1727,-,Verified
RAD50,YNL250W,14,175411,179349,3938,+,Verified
MPA43,YNL249C,14,179395,181023,1628,-,Verified
RPA49,YNL248C,14,181362,182609,1247,-,Verified
YNL247W,YNL247W,14,182876,185179,2303,+,Verified
VPS75,YNL246W,14,185461,186350,889,+,Verified
CWC25,YNL245C,14,186347,186886,539,-,Verified
SUI1,YNL244C,14,187171,187497,326,-,Verified
SLA2,YNL243W,14,188052,190958,2906,+,Verified
ATG2,YNL242W,14,191325,196103,4778,+,Verified
ZWF1,YNL241C,14,196427,197944,1517,-,Verified
NAR1,YNL240C,14,198503,199978,1475,-,Verified
LAP3,YNL239W,14,200570,201934,1364,+,Verified
KEX2,YNL238W,14,202429,204873,2444,+,Verified
YTP1,YNL237W,14,205189,206568,1379,+,Verified
SIN4,YNL236W,14,206931,209855,2924,+,Verified
YNL235C,YNL235C,14,209549,209980,431,-,Dubious
YNL234W,YNL234W,14,210234,211514,1280,+,Uncharacterized
BNI4,YNL233W,14,211923,214601,2678,+,Verified
CSL4,YNL232W,14,214924,215802,878,+,Verified
PDR16,YNL231C,14,215988,217043,1055,-,Verified
ELA1,YNL230C,14,217524,218663,1139,-,Verified
URE2,YNL229C,14,219138,220202,1064,-,Verified
YNL228W,YNL228W,14,220646,221422,776,+,Dubious
JJJ1,YNL227C,14,220660,222432,1772,-,Verified
YNL226W,YNL226W,14,222240,222650,410,+,Dubious
CNM67,YNL225C,14,222725,224470,1745,-,Verified
SQS1,YNL224C,14,224797,227100,2303,-,Verified
ATG4,YNL223W,14,227371,228855,1484,+,Verified
SSU72,YNL222W,14,229095,229715,620,+,Verified
POP1,YNL221C,14,231069,233696,2627,-,Verified
ADE12,YNL220W,14,234414,235715,1301,+,Verified
ALG9,YNL219C,14,235997,237664,1667,-,Verified
MGS1,YNL218W,14,238239,240002,1763,+,Verified
YNL217W,YNL217W,14,240332,241312,980,+,Uncharacterized
RAP1,YNL216W,14,241690,244173,2483,+,Verified
IES2,YNL215W,14,244469,245431,962,+,Verified
PEX17,YNL214W,14,245618,246217,599,+,Verified
YNL213C,YNL213C,14,246461,247105,644,-,Verified
VID27,YNL212W,14,247462,249810,2348,+,Verified
YNL211C,YNL211C,14,250056,250316,260,-,Uncharacterized
MER1,YNL210W,14,250932,251744,812,+,Verified
SSB2,YNL209W,14,252060,253901,1841,+,Verified
YNL208W,YNL208W,14,254419,255018,599,+,Verified
RIO2,YNL207W,14,255354,256631,1277,+,Verified
RTT106,YNL206C,14,256789,258156,1367,-,Verified
YNL205C,YNL205C,14,258156,258578,422,-,Dubious
SPS18,YNL204C,14,258376,259278,902,-,Verified
YNL203C,YNL203C,14,259440,260051,611,-,Dubious
SPS19,YNL202W,14,259579,260457,878,+,Verified
PSY2,YNL201C,14,260628,263204,2576,-,Verified
YNL200C,YNL200C,14,263714,264454,740,-,Uncharacterized
GCR2,YNL199C,14,264927,266531,1604,-,Verified
YNL198C,YNL198C,14,266515,266817,302,-,Dubious
WHI3,YNL197C,14,267609,269594,1985,-,Verified
SLZ1,YNL196C,14,270276,271172,896,-,Uncharacterized
YNL195C,YNL195C,14,271524,272309,785,-,Uncharacterized
YNL194C,YNL194C,14,272711,273616,905,-,Verified
YNL193W,YNL193W,14,274369,276045,1676,+,Uncharacterized
CHS1,YNL192W,14,276503,279898,3395,+,Verified
DUG3,YNL191W,14,280433,281506,1073,+,Verified
YNL190W,YNL190W,14,282396,283010,614,+,Uncharacterized
SRP1,YNL189W,14,284261,285889,1628,+,Verified
KAR1,YNL188W,14,286309,287610,1301,+,Verified
YNL187W,YNL187W,14,287996,289069,1073,+,Uncharacterized
UBP10,YNL186W,14,289500,291878,2378,+,Verified
MRPL19,YNL185C,14,292195,292671,476,-,Verified
YNL184C,YNL184C,14,292559,292885,326,-,Dubious
NPR1,YNL183C,14,293139,295511,2372,-,Verified
IPI3,YNL182C,14,295962,297629,1667,-,Verified
YNL181W,YNL181W,14,298337,299560,1223,+,Uncharacterized
RHO5,YNL180C,14,299656,300651,995,-,Verified
YNL179C,YNL179C,14,300668,301105,437,-,Dubious
RPS3,YNL178W,14,302682,303404,722,+,Verified
MRPL22,YNL177C,14,303688,304617,929,-,Verified
YNL176C,YNL176C,14,305072,306982,1910,-,Uncharacterized
NOP13,YNL175C,14,307403,308614,1211,-,Verified
YNL174W,YNL174W,14,308076,308648,572,+,Dubious
MDG1,YNL173C,14,308959,310059,1100,-,Verified
APC1,YNL172W,14,310638,315884,5246,+,Verified
YNL171C,YNL171C,14,315631,315999,368,-,Dubious
YNL170W,YNL170W,14,315980,316375,395,+,Dubious
PSD1,YNL169C,14,316171,317673,1502,-,Verified
FMP41,YNL168C,14,318032,318811,779,-,Uncharacterized
SKO1,YNL167C,14,319418,321361,1943,-,Verified
BNI5,YNL166C,14,322221,323567,1346,-,Verified
YNL165W,YNL165W,14,323834,325054,1220,+,Uncharacterized
IBD2,YNL164C,14,325267,326322,1055,-,Verified
RIA1,YNL163C,14,326743,330075,3332,-,Verified
YNL162W-A,YNL162W-A,14,330331,330549,218,+,Uncharacterized
RPL42A,YNL162W,14,331324,332156,832,+,Verified
CBK1,YNL161W,14,332599,334869,2270,+,Verified
YGP1,YNL160W,14,336547,337611,1064,+,Verified
ASI2,YNL159C,14,338480,339349,869,-,Verified
PGA1,YNL158W,14,339614,340210,596,+,Verified
IGO1,YNL157W,14,340354,340860,506,+,Uncharacterized
NSG2,YNL156C,14,341071,341970,899,-,Verified
YNL155W,YNL155W,14,342518,343342,824,+,Uncharacterized
YCK2,YNL154C,14,343638,345278,1640,-,Verified
GIM3,YNL153C,14,345671,346060,389,-,Verified
INN1,YNL152W,14,346315,347544,1229,+,Verified
RPC31,YNL151C,14,347768,348523,755,-,Verified
YNL150W,YNL150W,14,349253,349660,407,+,Dubious
PGA2,YNL149C,14,349369,349758,389,-,Uncharacterized
ALF1,YNL148C,14,349909,350673,764,-,Verified
LSM7,YNL147W,14,350942,351385,443,+,Verified
YNL146C-A,YNL146C-A,14,351388,351582,194,-,Uncharacterized
YNL146W,YNL146W,14,351717,352019,302,+,Uncharacterized
MFA2,YNL145W,14,352416,352532,116,+,Verified
YNL144C,YNL144C,14,352822,355044,2222,-,Uncharacterized
YNL144W-A,YNL144W-A,14,353063,353146,83,+,Dubious
YNL143C,YNL143C,14,356796,357188,392,-,Dubious
MEP2,YNL142W,14,357455,358954,1499,+,Verified
AAH1,YNL141W,14,359598,360641,1043,+,Verified
YNL140C,YNL140C,14,360919,361488,569,-,Dubious
THO2,YNL139C,14,360926,365719,4793,-,Verified
YSF3,YNL138W-A,14,366035,366414,379,+,Verified
SRV2,YNL138W,14,366743,368323,1580,+,Verified
NAM9,YNL137C,14,368597,370057,1460,-,Verified
EAF7,YNL136W,14,370370,371647,1277,+,Verified
FPR1,YNL135C,14,371884,372228,344,-,Verified
YNL134C,YNL134C,14,372453,373583,1130,-,Uncharacterized
FYV6,YNL133C,14,374173,374694,521,-,Verified
KRE33,YNL132W,14,375323,378493,3170,+,Verified
TOM22,YNL131W,14,378769,379227,458,+,Verified
CPT1,YNL130C,14,379560,380833,1273,-,Verified
YNL130C-A,YNL130C-A,14,381247,381393,146,-,Uncharacterized
NRK1,YNL129W,14,381482,382204,722,+,Verified
TEP1,YNL128W,14,382361,383665,1304,+,Verified
FAR11,YNL127W,14,383989,386850,2861,+,Verified
SPC98,YNL126W,14,387229,389769,2540,+,Verified
ESBP6,YNL125C,14,390148,392169,2021,-,Verified
NAF1,YNL124W,14,392894,394372,1478,+,Verified
NMA111,YNL123W,14,394687,397680,2993,+,Verified
YNL122C,YNL122C,14,398025,398372,347,-,Uncharacterized
TOM70,YNL121C,14,398686,400539,1853,-,Verified
YNL120C,YNL120C,14,401035,401520,485,-,Dubious
NCS2,YNL119W,14,401042,402523,1481,+,Uncharacterized
DCP2,YNL118C,14,402654,405566,2912,-,Verified
MLS1,YNL117W,14,406360,408024,1664,+,Verified
DMA2,YNL116W,14,408343,409911,1568,+,Verified
YNL115C,YNL115C,14,410121,412055,1934,-,Uncharacterized
YNL114C,YNL114C,14,412686,413057,371,-,Dubious
RPC19,YNL113W,14,412773,413201,428,+,Verified
DBP2,YNL112W,14,413641,416283,2642,+,Verified
CYB5,YNL111C,14,416942,417304,362,-,Verified
NOP15,YNL110C,14,417828,418490,662,-,Verified
YNL109W,YNL109W,14,418966,419511,545,+,Dubious
YNL108C,YNL108C,14,419016,419828,812,-,Uncharacterized
YAF9,YNL107W,14,420100,420780,680,+,Verified
INP52,YNL106C,14,420946,424497,3551,-,Verified
YNL105W,YNL105W,14,424157,424585,428,+,Dubious
LEU4,YNL104C,14,424897,426756,1859,-,Verified
YNL103W-A,YNL103W-A,14,426721,426810,89,+,Dubious
MET4,YNL103W,14,427737,429755,2018,+,Verified
POL1,YNL102W,14,430089,434495,4406,+,Verified
AVT4,YNL101W,14,435001,437142,2141,+,Verified
AIM37,YNL100W,14,437615,438319,704,+,Uncharacterized
OCA1,YNL099C,14,438569,439285,716,-,Verified
RAS2,YNL098C,14,439604,440572,968,-,Verified
YNL097C-B,YNL097C-B,14,440799,440921,122,-,Uncharacterized
PHO23,YNL097C,14,441368,442360,992,-,Verified
YNL097W-A,YNL097W-A,14,441433,441588,155,+,Dubious
RPS7B,YNL096C,14,443400,444317,917,-,Verified
YNL095C,YNL095C,14,444914,446842,1928,-,Uncharacterized
APP1,YNL094W,14,447613,449376,1763,+,Verified
YPT53,YNL093W,14,449870,450532,662,+,Verified
YNL092W,YNL092W,14,450873,452075,1202,+,Uncharacterized
NST1,YNL091W,14,452410,456132,3722,+,Verified
RHO2,YNL090W,14,456567,457145,578,+,Verified
YNL089C,YNL089C,14,456695,457171,476,-,Dubious
TOP2,YNL088W,14,457706,461992,4286,+,Verified
TCB2,YNL087W,14,462413,465949,3536,+,Verified
YNL086W,YNL086W,14,466336,466644,308,+,Uncharacterized
MKT1,YNL085W,14,467133,469625,2492,+,Verified
END3,YNL084C,14,470055,471104,1049,-,Verified
SAL1,YNL083W,14,471379,473016,1637,+,Verified
PMS1,YNL082W,14,473392,476013,2621,+,Verified
SWS2,YNL081C,14,476189,476620,431,-,Verified
EOS1,YNL080C,14,476933,478033,1100,-,Verified
TPM1,YNL079C,14,478567,479166,599,-,Verified
NIS1,YNL078W,14,479769,480992,1223,+,Verified
APJ1,YNL077W,14,481392,482978,1586,+,Verified
MKS1,YNL076W,14,483557,485311,1754,+,Verified
IMP4,YNL075W,14,485608,486480,872,+,Verified
MLF3,YNL074C,14,486767,488125,1358,-,Verified
MSK1,YNL073W,14,488387,490117,1730,+,Verified
RNH201,YNL072W,14,490318,491241,923,+,Verified
LAT1,YNL071W,14,491524,492972,1448,+,Verified
TOM7,YNL070W,14,493367,493549,182,+,Verified
RPL16B,YNL069C,14,493957,495002,1045,-,Verified
FKH2,YNL068C,14,495702,498290,2588,-,Verified
YNL067W-A,YNL067W-A,14,498539,498685,146,+,Dubious
YNL067W-B,YNL067W-B,14,499418,499558,140,+,Uncharacterized
RPL9B,YNL067W,14,499682,500257,575,+,Verified
SUN4,YNL066W,14,501158,502778,1620,+,Verified
AQR1,YNL065W,14,503725,505485,1760,+,Verified
YDJ1,YNL064C,14,505869,507098,1229,-,Verified
MTQ1,YNL063W,14,507759,508703,944,+,Verified
GCD10,YNL062C,14,508777,510213,1436,-,Verified
NOP2,YNL061W,14,510541,512397,1856,+,Verified
ARP5,YNL059C,14,512669,514936,2267,-,Verified
YNL058C,YNL058C,14,515764,516714,950,-,Uncharacterized
YNL057W,YNL057W,14,516404,516736,332,+,Dubious
OCA2,YNL056W,14,517250,517843,593,+,Verified
POR1,YNL055C,14,517995,518846,851,-,Verified
VAC7,YNL054W,14,526087,529584,3497,+,Verified
MSG5,YNL053W,14,529943,531412,1469,+,Verified
COX5A,YNL052W,14,531726,532187,461,+,Verified
COG5,YNL051W,14,532660,533871,1211,+,Verified
YNL050C,YNL050C,14,534080,534983,903,-,Uncharacterized
SFB2,YNL049C,14,535282,537912,2630,-,Verified
ALG11,YNL048W,14,538174,539820,1646,+,Verified
SLM2,YNL047C,14,539912,541882,1970,-,Verified
YNL046W,YNL046W,14,542305,542823,518,+,Uncharacterized
YNL045W,YNL045W,14,542964,544979,2015,+,Verified
YIP3,YNL044W,14,545269,545878,609,+,Verified
YNL043C,YNL043C,14,545590,545910,320,-,Dubious
YNL042W-B,YNL042W-B,14,547114,547371,257,+,Uncharacterized
BOP3,YNL042W,14,548101,549291,1190,+,Verified
COG6,YNL041C,14,549469,551988,2519,-,Verified
YNL040W,YNL040W,14,553381,554751,1370,+,Uncharacterized
BDP1,YNL039W,14,555049,556833,1784,+,Verified
GPI15,YNL038W,14,557021,557784,763,+,Verified
IDH1,YNL037C,14,557921,559003,1082,-,Verified
NCE103,YNL036W,14,559815,560480,665,+,Verified
YNL035C,YNL035C,14,568523,569692,1169,-,Uncharacterized
YNL034W,YNL034W,14,570478,572316,1838,+,Uncharacterized
YNL033W,YNL033W,14,573000,573854,854,+,Uncharacterized
SIW14,YNL032W,14,574507,575352,845,+,Verified
HHT2,YNL031C,14,575641,576051,410,-,Verified
HHF2,YNL030W,14,576728,577039,311,+,Verified
KTR5,YNL029C,14,577206,578774,1568,-,Verified
YNL028W,YNL028W,14,578680,578997,317,+,Dubious
CRZ1,YNL027W,14,579581,581617,2036,+,Verified
SAM50,YNL026W,14,581921,583375,1454,+,Verified
SSN8,YNL025C,14,584321,585292,971,-,Verified
YNL024C-A,YNL024C-A,14,586603,586821,218,-,Uncharacterized
YNL024C,YNL024C,14,587108,587848,740,-,Uncharacterized
FAP1,YNL023C,14,588264,591161,2897,-,Verified
YNL022C,YNL022C,14,591428,592900,1472,-,Uncharacterized
HDA1,YNL021W,14,593228,595348,2120,+,Verified
ARK1,YNL020C,14,595624,597540,1916,-,Verified
YNL019C,YNL019C,14,598377,599231,854,-,Uncharacterized
YNL018C,YNL018C,14,599937,601775,1838,-,Uncharacterized
YNL017C,YNL017C,14,602139,602477,338,-,Dubious
PUB1,YNL016W,14,602908,604269,1361,+,Verified
PBI2,YNL015W,14,605385,605612,227,+,Verified
HEF3,YNL014W,14,606320,609454,3134,+,Verified
YNL013C,YNL013C,14,609134,609511,377,-,Dubious
SPO1,YNL012W,14,609687,611666,1979,+,Verified
YNL011C,YNL011C,14,611837,613171,1334,-,Uncharacterized
YNL010W,YNL010W,14,613636,614361,725,+,Uncharacterized
IDP3,YNL009W,14,614822,616084,1262,+,Verified
ASI3,YNL008C,14,616212,618221,2009,-,Verified
SIS1,YNL007C,14,618509,619567,1058,-,Verified
LST8,YNL006W,14,620069,620980,911,+,Verified
MRP7,YNL005C,14,621315,622430,1115,-,Verified
HRB1,YNL004W,14,622917,624623,1706,+,Verified
PET8,YNL003C,14,624977,625831,854,-,Verified
RLP7,YNL002C,14,626176,627144,968,-,Verified
DOM34,YNL001W,14,627458,628618,1160,+,Verified
CIT1,YNR001C,14,629624,631063,1439,-,Verified
YNR001W-A,YNR001W-A,14,631265,631483,218,+,Dubious
ATO2,YNR002C,14,633010,633858,848,-,Verified
RPC34,YNR003C,14,634346,635299,953,-,Verified
YNR003W-A,YNR003W-A,14,634422,634520,98,+,Dubious
YNR004W,YNR004W,14,635945,636385,440,+,Uncharacterized
YNR005C,YNR005C,14,636933,637337,404,-,Dubious
VPS27,YNR006W,14,636988,638856,1868,+,Verified
ATG3,YNR007C,14,639184,640116,932,-,Verified
LRO1,YNR008W,14,640398,642383,1985,+,Verified
NRM1,YNR009W,14,642692,643441,749,+,Verified
CSE2,YNR010W,14,643746,644195,449,+,Verified
PRP2,YNR011C,14,644322,646952,2630,-,Verified
URK1,YNR012W,14,647434,648939,1505,+,Verified
PHO91,YNR013C,14,649030,651714,2684,-,Verified
YNR014W,YNR014W,14,652467,653105,638,+,Uncharacterized
SMM1,YNR015W,14,653389,654543,1154,+,Verified
ACC1,YNR016C,14,654675,661376,6701,-,Verified
TIM23,YNR017W,14,662915,663583,668,+,Verified
AIM38,YNR018W,14,664272,664946,674,+,Uncharacterized
ARE2,YNR019W,14,665341,667269,1928,+,Verified
ATP23,YNR020C,14,667412,668224,812,-,Verified
YNR021W,YNR021W,14,668379,669593,1214,+,Uncharacterized
MRPL50,YNR022C,14,669776,670195,419,-,Verified
SNF12,YNR023W,14,670420,672120,1700,+,Verified
YNR024W,YNR024W,14,672411,672971,560,+,Verified
YNR025C,YNR025C,14,672704,673063,359,-,Dubious
SEC12,YNR026C,14,673276,674691,1415,-,Verified
BUD17,YNR027W,14,674925,675878,953,+,Verified
CPR8,YNR028W,14,676179,677105,926,+,Verified
YNR029C,YNR029C,14,677201,678490,1289,-,Uncharacterized
ALG12,YNR030W,14,678801,680456,1655,+,Verified
SSK2,YNR031C,14,680696,685435,4739,-,Verified
PPG1,YNR032W,14,686012,687118,1106,+,Verified
HUB1,YNR032C-A,14,687245,687466,221,-,Verified
ABZ1,YNR033W,14,687637,690000,2363,+,Verified
SOL1,YNR034W,14,690323,691288,965,+,Verified
YNR034W-A,YNR034W-A,14,692563,692859,296,+,Uncharacterized
ARC35,YNR035C,14,693021,694049,1028,-,Verified
YNR036C,YNR036C,14,694363,694824,461,-,Verified
RSM19,YNR037C,14,695054,695329,275,-,Verified
DBP6,YNR038W,14,695597,697486,1889,+,Verified
ZRG17,YNR039C,14,697616,699433,1817,-,Verified
YNR040W,YNR040W,14,699692,700462,770,+,Uncharacterized
COQ2,YNR041C,14,700543,701661,1118,-,Verified
YNR042W,YNR042W,14,701240,701668,428,+,Dubious
MVD1,YNR043W,14,701897,703087,1190,+,Verified
AGA1,YNR044W,14,703701,705878,2177,+,Verified
PET494,YNR045W,14,706141,707610,1469,+,Verified
TRM112,YNR046W,14,707790,708197,407,+,Verified
YNR047W,YNR047W,14,708525,711206,2681,+,Uncharacterized
YNR048W,YNR048W,14,711632,712813,1181,+,Verified
MSO1,YNR049C,14,713025,713657,632,-,Verified
LYS9,YNR050C,14,714050,715390,1340,-,Verified
BRE5,YNR051C,14,716782,718329,1547,-,Verified
POP2,YNR052C,14,719348,720649,1301,-,Verified
NOG2,YNR053C,14,721122,723113,1991,-,Verified
ESF2,YNR054C,14,723357,724307,950,-,Verified
HOL1,YNR055C,14,728427,730187,1760,-,Verified
BIO5,YNR056C,14,731618,733303,1685,-,Verified
BIO4,YNR057C,14,733356,734069,713,-,Verified
BIO3,YNR058W,14,734291,735733,1442,+,Verified
MNT4,YNR059W,14,736803,738545,1742,+,Verified
FRE4,YNR060W,14,739951,742110,2159,+,Verified
YNR061C,YNR061C,14,742881,743540,659,-,Uncharacterized
YNR062C,YNR062C,14,744360,745343,983,-,Uncharacterized
YNR063W,YNR063W,14,746943,748766,1823,+,Uncharacterized
YNR064C,YNR064C,14,749136,750008,872,-,Verified
YNR065C,YNR065C,14,750350,753700,3350,-,Uncharacterized
YNR066C,YNR066C,14,753725,755035,1310,-,Uncharacterized
DSE4,YNR067C,14,755746,759099,3353,-,Verified
YNR068C,YNR068C,14,760067,760885,818,-,Uncharacterized
BSC5,YNR069C,14,761123,762592,1469,-,Verified
YNR070W,YNR070W,14,765375,769376,4001,+,Uncharacterized
YNR071C,YNR071C,14,770440,771468,1028,-,Uncharacterized
HXT17,YNR072W,14,772657,774351,1694,+,Verified
YNR073C,YNR073C,14,774792,776300,1508,-,Uncharacterized
AIF1,YNR074C,14,777602,778738,1136,-,Verified
COS10,YNR075W,14,779916,781040,1124,+,Verified
YNR075C-A,YNR075C-A,14,781511,781603,92,-,Uncharacterized
PAU6,YNR076W,14,781918,782280,362,+,Verified
YNR077C,YNR077C,14,783287,783541,254,-,Dubious
YOL166W-A,YOL166W-A,15,585,740,155,+,Uncharacterized
YOL166C,YOL166C,15,1000,1338,338,-,Dubious
AAD15,YOL165C,15,1647,2078,431,-,Verified
YOL164W-A,YOL164W-A,15,4130,4312,182,+,Uncharacterized
BDS1,YOL164W,15,6175,8115,1940,+,Verified
YOL163W,YOL163W,15,9596,10105,509,+,Uncharacterized
YOL162W,YOL162W,15,10118,10765,647,+,Uncharacterized
PAU20,YOL161C,15,11548,11910,362,-,Uncharacterized
YOL160W,YOL160W,15,14312,14653,341,+,Dubious
YOL159C-A,YOL159C-A,15,15232,15504,272,-,Uncharacterized
YOL159C,YOL159C,15,17280,17795,515,-,Verified
ENB1,YOL158C,15,19490,21310,1820,-,Verified
YOL157C,YOL157C,15,22524,24293,1769,-,Uncharacterized
HXT11,YOL156W,15,25272,26975,1703,+,Verified
YOL155W-A,YOL155W-A,15,27083,27217,134,+,Uncharacterized
HPF1,YOL155C,15,28702,31605,2903,-,Verified
ZPS1,YOL154W,15,34657,35406,749,+,Verified
FRE7,YOL152W,15,40747,42609,1862,+,Verified
GRE2,YOL151W,15,43693,44721,1028,+,Verified
YOL150C,YOL150C,15,44472,44783,311,-,Dubious
DCP1,YOL149W,15,44937,45632,695,+,Verified
SPT20,YOL148C,15,45759,47573,1814,-,Verified
PEX11,YOL147C,15,47932,48642,710,-,Verified
PSF3,YOL146W,15,48863,49447,584,+,Verified
CTR9,YOL145C,15,49554,52787,3233,-,Verified
NOP8,YOL144W,15,53097,54551,1454,+,Verified
RIB4,YOL143C,15,54594,55103,509,-,Verified
RRP40,YOL142W,15,55557,56279,722,+,Verified
PPM2,YOL141W,15,56451,58538,2087,+,Verified
ARG8,YOL140W,15,58759,60030,1271,+,Verified
CDC33,YOL139C,15,60383,61024,641,-,Verified
RTC1,YOL138C,15,61325,65350,4025,-,Verified
BSC6,YOL137W,15,65621,67114,1493,+,Verified
PFK27,YOL136C,15,67561,68754,1193,-,Verified
MED7,YOL135C,15,69376,70044,668,-,Verified
YOL134C,YOL134C,15,70156,70545,389,-,Dubious
HRT1,YOL133W,15,70325,70690,365,+,Verified
GAS4,YOL132W,15,71300,72715,1415,+,Verified
YOL131W,YOL131W,15,73031,73357,326,+,Uncharacterized
ALR1,YOL130W,15,74400,76979,2579,+,Verified
VPS68,YOL129W,15,77560,78114,554,+,Verified
YGK3,YOL128C,15,78352,79479,1127,-,Verified
RPL25,YOL127W,15,80348,81190,842,+,Verified
MDH2,YOL126C,15,81787,82920,1133,-,Verified
TRM13,YOL125W,15,83834,85264,1430,+,Verified
TRM11,YOL124C,15,85456,86757,1301,-,Verified
HRP1,YOL123W,15,87844,89448,1604,+,Verified
SMF1,YOL122C,15,89692,91419,1727,-,Verified
RPS19A,YOL121C,15,92026,92850,824,-,Verified
RPL18A,YOL120C,15,93395,94402,1007,-,Verified
MCH4,YOL119C,15,94856,96361,1505,-,Verified
YOL118C,YOL118C,15,96608,96916,308,-,Dubious
RRI2,YOL117W,15,97551,99488,1937,+,Verified
MSN1,YOL116W,15,99809,100957,1148,+,Verified
PAP2,YOL115W,15,101475,103229,1754,+,Verified
YOL114C,YOL114C,15,103317,103925,608,-,Uncharacterized
SKM1,YOL113W,15,104326,106293,1967,+,Verified
MSB4,YOL112W,15,106710,108188,1478,+,Verified
MDY2,YOL111C,15,108258,108896,638,-,Verified
SHR5,YOL110W,15,109176,109889,713,+,Verified
ZEO1,YOL109W,15,110297,110638,341,+,Verified
INO4,YOL108C,15,111431,111886,455,-,Verified
YOL107W,YOL107W,15,112102,113130,1028,+,Uncharacterized
YOL106W,YOL106W,15,113226,113579,353,+,Dubious
WSC3,YOL105C,15,114138,115808,1670,-,Verified
NDJ1,YOL104C,15,116396,117454,1058,-,Verified
ITR2,YOL103W,15,124001,125830,1829,+,Verified
TPT1,YOL102C,15,125997,126689,692,-,Verified
IZH4,YOL101C,15,126982,127920,938,-,Verified
PKH2,YOL100W,15,129237,132482,3245,+,Verified
YOL099C,YOL099C,15,132017,132508,491,-,Dubious
YOL098C,YOL098C,15,132725,135838,3113,-,Uncharacterized
YOL097W-A,YOL097W-A,15,136220,136405,185,+,Uncharacterized
WRS1,YOL097C,15,136527,137825,1298,-,Verified
COQ3,YOL096C,15,138107,139045,938,-,Verified
HMI1,YOL095C,15,139227,141347,2120,-,Verified
RFC4,YOL094C,15,141584,142555,971,-,Verified
TRM10,YOL093W,15,142815,143696,881,+,Verified
YOL092W,YOL092W,15,144204,145130,926,+,Uncharacterized
SPO21,YOL091W,15,145334,147163,1829,+,Verified
MSH2,YOL090W,15,147382,150276,2894,+,Verified
HAL9,YOL089C,15,150398,153490,3092,-,Verified
MPD2,YOL088C,15,153912,154745,833,-,Verified
YOL087C,YOL087C,15,155287,158637,3350,-,Uncharacterized
YOL086W-A,YOL086W-A,15,159173,159445,272,+,Uncharacterized
ADH1,YOL086C,15,159548,160594,1046,-,Verified
YOL085W-A,YOL085W-A,15,161579,161791,212,+,Dubious
YOL085C,YOL085C,15,161673,162014,341,-,Dubious
PHM7,YOL084W,15,162356,165331,2975,+,Verified
YOL083W,YOL083W,15,165714,166952,1238,+,Uncharacterized
YOL083C-A,YOL083C-A,15,166461,166601,140,-,Dubious
ATG19,YOL082W,15,168727,169974,1247,+,Verified
IRA2,YOL081W,15,171070,180309,9239,+,Verified
REX4,YOL080C,15,180558,181427,869,-,Verified
YOL079W,YOL079W,15,181057,181455,398,+,Dubious
AVO1,YOL078W,15,181682,185212,3530,+,Verified
ATP19,YOL077W-A,15,185438,185644,206,+,Verified
BRX1,YOL077C,15,185848,186723,875,-,Verified
MDM20,YOL076W,15,187024,189414,2390,+,Verified
YOL075C,YOL075C,15,189658,193542,3884,-,Uncharacterized
YOL073C,YOL073C,15,193832,194800,968,-,Uncharacterized
THP1,YOL072W,15,194970,196337,1367,+,Verified
EMI5,YOL071W,15,196507,196995,488,+,Verified
NBA1,YOL070C,15,197220,198725,1505,-,Verified
NUF2,YOL069W,15,198942,200297,1355,+,Verified
HST1,YOL068C,15,200368,201879,1511,-,Verified
RTG1,YOL067C,15,201985,202518,533,-,Verified
RIB2,YOL066C,15,202696,204471,1775,-,Verified
INP54,YOL065C,15,204731,205885,1154,-,Verified
MET22,YOL064C,15,206103,207176,1073,-,Verified
CRT10,YOL063C,15,207392,210265,2873,-,Verified
APM4,YOL062C,15,210520,211995,1475,-,Verified
PRS5,YOL061W,15,212244,213734,1490,+,Verified
MAM3,YOL060C,15,214017,216137,2120,-,Verified
GPD2,YOL059W,15,217126,218448,1322,+,Verified
ARG1,YOL058W,15,219210,220472,1262,+,Verified
YOL057W,YOL057W,15,220766,222901,2135,+,Uncharacterized
GPM3,YOL056W,15,223267,224178,911,+,Verified
THI20,YOL055C,15,224419,226074,1655,-,Verified
PSH1,YOL054W,15,228613,229833,1220,+,Uncharacterized
AIM39,YOL053W,15,230084,231271,1187,+,Uncharacterized
DDR2,YOL052C-A,15,231569,231754,185,-,Verified
SPE2,YOL052C,15,232445,233635,1190,-,Verified
GAL11,YOL051W,15,234939,238184,3245,+,Verified
YOL050C,YOL050C,15,237881,238201,320,-,Dubious
GSH2,YOL049W,15,238618,240093,1475,+,Verified
YOL048C,YOL048C,15,240203,241309,1106,-,Uncharacterized
YOL047C,YOL047C,15,241613,242746,1133,-,Uncharacterized
YOL046C,YOL046C,15,243465,244139,674,-,Dubious
PSK2,YOL045W,15,243496,246801,3305,+,Verified
PEX15,YOL044W,15,247149,248300,1151,+,Verified
NTG2,YOL043C,15,248391,249533,1142,-,Verified
NGL1,YOL042W,15,249824,250915,1091,+,Verified
NOP12,YOL041C,15,251266,252645,1379,-,Verified
RPS15,YOL040C,15,253148,253576,428,-,Verified
RPP2A,YOL039W,15,254296,254616,320,+,Verified
YOL038C-A,YOL038C-A,15,254925,255020,95,-,Uncharacterized
PRE6,YOL038W,15,255336,256100,764,+,Verified
YOL037C,YOL037C,15,256665,257018,353,-,Dubious
YOL036W,YOL036W,15,256744,259029,2285,+,Uncharacterized
YOL035C,YOL035C,15,258802,259104,302,-,Dubious
SMC5,YOL034W,15,259924,263205,3281,+,Verified
MSE1,YOL033W,15,263476,265086,1610,+,Verified
OPI10,YOL032W,15,265430,266170,740,+,Verified
SIL1,YOL031C,15,266265,267530,1265,-,Verified
GAS5,YOL030W,15,268188,269642,1454,+,Verified
YOL029C,YOL029C,15,269816,270421,605,-,Uncharacterized
YAP7,YOL028C,15,270634,271371,737,-,Verified
MDM38,YOL027C,15,272004,273725,1721,-,Verified
MIM1,YOL026C,15,274013,274354,341,-,Verified
LAG2,YOL025W,15,274958,276940,1982,+,Verified
YOL024W,YOL024W,15,277087,277605,518,+,Uncharacterized
IFM1,YOL023W,15,278057,280087,2030,+,Verified
TSR4,YOL022C,15,280273,281499,1226,-,Uncharacterized
DIS3,YOL021C,15,282422,285427,3005,-,Verified
TAT2,YOL020W,15,286173,287951,1778,+,Verified
YOL019W-A,YOL019W-A,15,288421,288573,152,+,Uncharacterized
YOL019W,YOL019W,15,288899,290554,1655,+,Uncharacterized
TLG2,YOL018C,15,290882,292075,1193,-,Verified
ESC8,YOL017W,15,292530,294674,2144,+,Verified
CMK2,YOL016C,15,294778,296121,1343,-,Verified
IRC10,YOL015W,15,297079,298839,1760,+,Verified
YOL014W,YOL014W,15,299694,300068,374,+,Uncharacterized
YOL013W-B,YOL013W-B,15,300691,300981,290,+,Dubious
YOL013W-A,YOL013W-A,15,301048,301239,191,+,Uncharacterized
HRD1,YOL013C,15,301381,303036,1655,-,Verified
HTZ1,YOL012C,15,303580,303984,404,-,Verified
PLB3,YOL011W,15,305350,307410,2060,+,Verified
RCL1,YOL010W,15,307939,309042,1103,+,Verified
MDM12,YOL009C,15,309325,310140,815,-,Verified
COQ10,YOL008W,15,310313,310936,623,+,Verified
CSI2,YOL007C,15,311343,312368,1025,-,Verified
TOP1,YOL006C,15,313079,315388,2309,-,Verified
RPB11,YOL005C,15,315814,316176,362,-,Verified
SIN3,YOL004W,15,316939,321549,4610,+,Verified
PFA4,YOL003C,15,321859,322995,1136,-,Verified
IZH2,YOL002C,15,323412,324365,953,-,Verified
PHO80,YOL001W,15,325250,326131,881,+,Verified
RRP6,YOR001W,15,326833,329034,2201,+,Verified
ALG6,YOR002W,15,329418,331052,1634,+,Verified
YSP3,YOR003W,15,331456,332892,1436,+,Verified
UTP23,YOR004W,15,333593,334357,764,+,Verified
DNL4,YOR005C,15,334510,337344,2834,-,Verified
TSR3,YOR006C,15,337681,338622,941,-,Uncharacterized
SGT2,YOR007C,15,338939,339979,1040,-,Verified
SLG1,YOR008C,15,341279,342415,1136,-,Verified
YOR008C-A,YOR008C-A,15,342858,343082,224,-,Uncharacterized
YOR008W-B,YOR008W-B,15,343929,344030,101,+,Dubious
TIR4,YOR009W,15,344335,345798,1463,+,Verified
TIR2,YOR010C,15,346195,346950,755,-,Verified
AUS1,YOR011W,15,349679,353863,4184,+,Verified
YOR011W-A,YOR011W-A,15,355652,355858,206,+,Uncharacterized
YOR012W,YOR012W,15,356543,356956,413,+,Uncharacterized
IRC11,YOR013W,15,356751,357221,470,+,Dubious
RTS1,YOR014W,15,357674,359947,2273,+,Verified
YOR015W,YOR015W,15,359993,360352,359,+,Dubious
ERP4,YOR016C,15,360461,361084,623,-,Verified
PET127,YOR017W,15,361412,363814,2402,+,Verified
ROD1,YOR018W,15,364369,366882,2513,+,Verified
YOR019W,YOR019W,15,368127,370319,2192,+,Verified
HSP10,YOR020C,15,370524,370844,320,-,Verified
YOR020W-A,YOR020W-A,15,371685,371957,272,+,Uncharacterized
YOR021C,YOR021C,15,372798,373439,641,-,Uncharacterized
YOR022C,YOR022C,15,373710,375857,2147,-,Uncharacterized
AHC1,YOR023C,15,376012,377712,1700,-,Verified
YOR024W,YOR024W,15,377847,378170,323,+,Dubious
HST3,YOR025W,15,378219,379562,1343,+,Verified
BUB3,YOR026W,15,379781,380806,1025,+,Verified
STI1,YOR027W,15,381053,382822,1769,+,Verified
CIN5,YOR028C,15,383533,384420,887,-,Verified
YOR029W,YOR029W,15,384600,384935,335,+,Dubious
DFG16,YOR030W,15,386825,388684,1859,+,Verified
CRS5,YOR031W,15,389213,389422,209,+,Verified
HMS1,YOR032C,15,389771,391075,1304,-,Verified
YOR032W-A,YOR032W-A,15,392176,392376,200,+,Uncharacterized
EXO1,YOR033C,15,392416,394524,2108,-,Verified
AKR2,YOR034C,15,394837,397086,2249,-,Verified
YOR034C-A,YOR034C-A,15,397426,397668,242,-,Uncharacterized
SHE4,YOR035C,15,397735,400104,2369,-,Verified
PEP12,YOR036W,15,400348,401214,866,+,Verified
CYC2,YOR037W,15,401555,402655,1100,+,Verified
HIR2,YOR038C,15,402761,405388,2627,-,Verified
CKB2,YOR039W,15,405768,406544,776,+,Verified
GLO4,YOR040W,15,407064,407921,857,+,Verified
YOR041C,YOR041C,15,408358,408789,431,-,Dubious
CUE5,YOR042W,15,408425,409660,1235,+,Verified
WHI2,YOR043W,15,410870,412330,1460,+,Verified
IRC23,YOR044W,15,413007,413480,473,+,Verified
TOM6,YOR045W,15,413852,414037,185,+,Verified
DBP5,YOR046C,15,414460,415908,1448,-,Verified
STD1,YOR047C,15,416348,417682,1334,-,Verified
RAT1,YOR048C,15,418631,421651,3020,-,Verified
RSB1,YOR049C,15,422669,423733,1064,-,Verified
YOR050C,YOR050C,15,424272,424619,347,-,Dubious
YOR051C,YOR051C,15,424848,426086,1238,-,Uncharacterized
YOR052C,YOR052C,15,426774,427226,452,-,Verified
YOR053W,YOR053W,15,427819,428160,341,+,Dubious
VHS3,YOR054C,15,427835,429859,2024,-,Verified
YOR055W,YOR055W,15,429480,429914,434,+,Dubious
NOB1,YOR056C,15,430249,431628,1379,-,Verified
SGT1,YOR057W,15,432188,433375,1187,+,Verified
ASE1,YOR058C,15,433690,436347,2657,-,Verified
YOR059C,YOR059C,15,438908,440260,1352,-,Uncharacterized
YOR060C,YOR060C,15,440392,441165,773,-,Uncharacterized
CKA2,YOR061W,15,441536,442555,1019,+,Verified
YOR062C,YOR062C,15,442727,443533,806,-,Uncharacterized
RPL3,YOR063W,15,444688,445851,1163,+,Verified
YNG1,YOR064C,15,446081,446740,659,-,Verified
CYT1,YOR065W,15,447441,448370,929,+,Verified
MSA1,YOR066W,15,449438,451327,1889,+,Uncharacterized
ALG8,YOR067C,15,451731,453464,1733,-,Verified
VPS5,YOR069W,15,453770,455797,2027,+,Verified
VAM10,YOR068C,15,453871,454215,344,-,Verified
GYP1,YOR070C,15,455909,457822,1913,-,Verified
NRT1,YOR071C,15,459482,461278,1796,-,Verified
YOR072W,YOR072W,15,461504,461818,314,+,Dubious
YOR072W-A,YOR072W-A,15,461793,462041,248,+,Dubious
YOR072W-B,YOR072W-B,15,464471,464632,161,+,Uncharacterized
SGO1,YOR073W,15,464773,466545,1772,+,Verified
CDC21,YOR074C,15,466677,467591,914,-,Verified
YOR073W-A,YOR073W-A,15,467392,467625,233,+,Dubious
UFE1,YOR075W,15,468214,469254,1040,+,Verified
SKI7,YOR076C,15,469379,471622,2243,-,Verified
RTS2,YOR077W,15,471901,472599,698,+,Verified
BUD21,YOR078W,15,472727,473371,644,+,Verified
ATX2,YOR079C,15,473477,474418,941,-,Verified
DIA2,YOR080W,15,474554,476794,2240,+,Verified
TGL5,YOR081C,15,476941,479190,2249,-,Verified
YOR082C,YOR082C,15,479298,479639,341,-,Dubious
WHI5,YOR083W,15,479535,480422,887,+,Verified
LPX1,YOR084W,15,480589,481752,1163,+,Verified
OST3,YOR085W,15,482035,483087,1052,+,Verified
TCB1,YOR086C,15,483221,486781,3560,-,Verified
YVC1,YOR087W,15,487709,489736,2027,+,Verified
VPS21,YOR089C,15,490198,490830,632,-,Verified
PTC5,YOR090C,15,491125,492843,1718,-,Verified
TMA46,YOR091W,15,493434,494471,1037,+,Verified
ECM3,YOR092W,15,495128,496969,1841,+,Verified
YOR093C,YOR093C,15,497507,502453,4946,-,Uncharacterized
ARF3,YOR094W,15,502796,503347,551,+,Verified
RKI1,YOR095C,15,503553,504329,776,-,Verified
RPS7A,YOR096W,15,505795,506768,973,+,Verified
YOR097C,YOR097C,15,506979,507506,527,-,Uncharacterized
NUP1,YOR098C,15,507949,511179,3230,-,Verified
KTR1,YOR099W,15,511826,513007,1181,+,Verified
CRC1,YOR100C,15,513296,514279,983,-,Verified
RAS1,YOR101W,15,515245,516174,929,+,Verified
YOR102W,YOR102W,15,516424,516774,350,+,Dubious
OST2,YOR103C,15,516450,516842,392,-,Verified
PIN2,YOR104W,15,517643,518491,848,+,Verified
YOR105W,YOR105W,15,518196,518522,326,+,Dubious
VAM3,YOR106W,15,519122,519973,851,+,Verified
RGS2,YOR107W,15,521354,522283,929,+,Verified
LEU9,YOR108W,15,523028,524842,1814,+,Verified
YOR108C-A,YOR108C-A,15,524606,524815,209,-,Dubious
INP53,YOR109W,15,525279,528602,3323,+,Verified
TFC7,YOR110W,15,528942,530249,1307,+,Verified
YOR111W,YOR111W,15,530430,531128,698,+,Uncharacterized
CEX1,YOR112W,15,531509,533794,2285,+,Verified
AZF1,YOR113W,15,534076,536820,2744,+,Verified
YOR114W,YOR114W,15,537571,538455,884,+,Uncharacterized
TRS33,YOR115C,15,538660,539466,806,-,Verified
RPO31,YOR116C,15,539764,544146,4382,-,Verified
RPT5,YOR117W,15,545030,546334,1304,+,Verified
RTC5,YOR118W,15,546858,548561,1703,+,Uncharacterized
RIO1,YOR119C,15,548793,550247,1454,-,Verified
GCY1,YOR120W,15,551115,552053,938,+,Verified
YOR121C,YOR121C,15,551799,552104,305,-,Dubious
PFY1,YOR122C,15,552299,552888,589,-,Verified
LEO1,YOR123C,15,553177,554571,1394,-,Verified
UBP2,YOR124C,15,554825,558643,3818,-,Verified
CAT5,YOR125C,15,559031,559732,701,-,Verified
IAH1,YOR126C,15,559962,560678,716,-,Verified
RGA1,YOR127W,15,561171,564194,3023,+,Verified
ADE2,YOR128C,15,564477,566192,1715,-,Verified
AFI1,YOR129C,15,566878,569559,2681,-,Verified
ORT1,YOR130C,15,569930,570808,878,-,Verified
YOR131C,YOR131C,15,572183,572839,656,-,Uncharacterized
VPS17,YOR132W,15,573176,574831,1655,+,Verified
EFT1,YOR133W,15,575099,577627,2528,+,Verified
BAG7,YOR134W,15,578565,579794,1229,+,Verified
IRC14,YOR135C,15,580160,580501,341,-,Dubious
IDH2,YOR136W,15,580251,581360,1109,+,Verified
SIA1,YOR137C,15,581814,583682,1868,-,Verified
RUP1,YOR138C,15,584310,586325,2015,-,Verified
YOR139C,YOR139C,15,586951,587343,392,-,Dubious
SFL1,YOR140W,15,586982,589282,2300,+,Verified
ARP8,YOR141C,15,589943,592588,2645,-,Verified
LSC1,YOR142W,15,593058,594047,989,+,Verified
THI80,YOR143C,15,601384,602343,959,-,Verified
ELG1,YOR144C,15,602718,605093,2375,-,Verified
PNO1,YOR145C,15,605348,606172,824,-,Verified
YOR146W,YOR146W,15,605874,606179,305,+,Dubious
MDM32,YOR147W,15,606608,608476,1868,+,Verified
SPP2,YOR148C,15,608641,609198,557,-,Verified
SMP3,YOR149C,15,609839,611389,1550,-,Verified
MRPL23,YOR150W,15,612000,612491,491,+,Verified
RPB2,YOR151C,15,612998,616672,3674,-,Verified
YOR152C,YOR152C,15,617519,618289,770,-,Uncharacterized
PDR5,YOR153W,15,619841,624376,4535,+,Verified
SLP1,YOR154W,15,624730,626493,1763,+,Uncharacterized
ISN1,YOR155C,15,626629,627981,1352,-,Verified
NFI1,YOR156C,15,628361,630541,2180,-,Verified
PUP1,YOR157C,15,630967,631752,785,-,Verified
PET123,YOR158W,15,632165,633121,956,+,Verified
SME1,YOR159C,15,633283,633567,284,-,Verified
MTR10,YOR160W,15,633840,636758,2918,+,Verified
PNS1,YOR161C,15,636940,638559,1619,-,Verified
YOR161W-A,YOR161W-A,15,637575,637655,80,+,Dubious
YOR161W-B,YOR161W-B,15,637976,638236,260,+,Dubious
YOR161C-C,YOR161C-C,15,639122,639268,146,-,Uncharacterized
YRR1,YOR162C,15,639561,641993,2432,-,Verified
DDP1,YOR163W,15,642742,643308,566,+,Verified
YOR164C,YOR164C,15,643395,644333,938,-,Verified
SEY1,YOR165W,15,644567,646897,2330,+,Verified
SWT1,YOR166C,15,647127,648503,1376,-,Verified
RPS28A,YOR167C,15,648805,649008,203,-,Verified
GLN4,YOR168W,15,649304,651733,2429,+,Verified
YOR169C,YOR169C,15,651377,651841,464,-,Dubious
YOR170W,YOR170W,15,651859,652164,305,+,Dubious
LCB4,YOR171C,15,652011,653885,1874,-,Verified
YRM1,YOR172W,15,654211,656571,2360,+,Verified
DCS2,YOR173W,15,657265,658326,1061,+,Verified
MED4,YOR174W,15,658748,659602,854,+,Verified
ALE1,YOR175C,15,659816,661675,1859,-,Verified
HEM15,YOR176W,15,662402,663583,1181,+,Verified
MPC54,YOR177C,15,665786,667180,1394,-,Verified
GAC1,YOR178C,15,667861,670242,2381,-,Verified
SYC1,YOR179C,15,671846,672412,566,-,Verified
DCI1,YOR180C,15,674353,675168,815,-,Verified
LAS17,YOR181W,15,675940,677841,1901,+,Verified
RPS30B,YOR182C,15,678192,678794,602,-,Verified
FYV12,YOR183W,15,678873,679262,389,+,Uncharacterized
SER1,YOR184W,15,679358,680545,1187,+,Verified
GSP2,YOR185C,15,681445,682107,662,-,Verified
YOR186W,YOR186W,15,683112,683546,434,+,Uncharacterized
YOR186C-A,YOR186C-A,15,683330,683539,209,-,Dubious
TUF1,YOR187W,15,684031,685344,1313,+,Verified
MSB1,YOR188W,15,685768,689181,3413,+,Verified
IES4,YOR189W,15,689625,689975,350,+,Verified
SPR1,YOR190W,15,690696,692033,1337,+,Verified
ULS1,YOR191W,15,692476,697335,4859,+,Verified
THI72,YOR192C,15,698769,700568,1799,-,Verified
YOR192C-C,YOR192C-C,15,703989,704225,236,-,Uncharacterized
PEX27,YOR193W,15,710447,711577,1130,+,Verified
TOA1,YOR194C,15,711684,712544,860,-,Verified
SLK19,YOR195W,15,712867,715332,2465,+,Verified
LIP5,YOR196C,15,715594,716838,1244,-,Verified
MCA1,YOR197W,15,717087,718385,1298,+,Verified
BFR1,YOR198C,15,718654,720066,1412,-,Verified
YOR199W,YOR199W,15,720182,720511,329,+,Dubious
YOR200W,YOR200W,15,720418,720816,398,+,Dubious
MRM1,YOR201C,15,720471,721709,1238,-,Verified
HIS3,YOR202W,15,721947,722609,662,+,Verified
YOR203W,YOR203W,15,722566,722919,353,+,Dubious
DED1,YOR204W,15,722912,724726,1814,+,Verified
LRC5,YOR205C,15,725565,727235,1670,-,Uncharacterized
NOC2,YOR206W,15,727513,729645,2132,+,Verified
RET1,YOR207C,15,730009,733458,3449,-,Verified
PTP2,YOR208W,15,733926,736178,2252,+,Verified
NPT1,YOR209C,15,736438,737727,1289,-,Verified
RPB10,YOR210W,15,738321,738533,212,+,Verified
MGM1,YOR211C,15,738925,741570,2645,-,Verified
STE4,YOR212W,15,742911,744182,1271,+,Verified
SAS5,YOR213C,15,744536,745282,746,-,Verified
YOR214C,YOR214C,15,745594,746304,710,-,Uncharacterized
AIM41,YOR215C,15,746726,747283,557,-,Uncharacterized
RUD3,YOR216C,15,747526,748980,1454,-,Verified
RFC1,YOR217W,15,749302,751887,2585,+,Verified
YOR218C,YOR218C,15,751477,751896,419,-,Dubious
STE13,YOR219C,15,752215,755010,2795,-,Verified
RCN2,YOR220W,15,755329,756126,797,+,Uncharacterized
MCT1,YOR221C,15,756477,757559,1082,-,Verified
ODC2,YOR222W,15,758331,759254,923,+,Verified
YOR223W,YOR223W,15,759783,760661,878,+,Uncharacterized
RPB8,YOR224C,15,760826,761266,440,-,Verified
YOR225W,YOR225W,15,761393,761722,329,+,Dubious
ISU2,YOR226C,15,761615,762085,470,-,Verified
YOR227W,YOR227W,15,762826,766566,3740,+,Verified
YOR228C,YOR228C,15,766870,767778,908,-,Verified
WTM2,YOR229W,15,768410,769813,1403,+,Verified
WTM1,YOR230W,15,770801,772114,1313,+,Verified
MKK1,YOR231W,15,772602,774128,1526,+,Verified
YOR231C-A,YOR231C-A,15,773164,773364,200,-,Dubious
MGE1,YOR232W,15,774574,775260,686,+,Verified
KIN4,YOR233W,15,775847,778249,2402,+,Verified
RPL33B,YOR234C,15,778556,779406,850,-,Verified
IRC13,YOR235W,15,779871,780185,314,+,Dubious
DFR1,YOR236W,15,780907,781542,635,+,Verified
HES1,YOR237W,15,781995,783299,1304,+,Verified
YOR238W,YOR238W,15,783678,784589,911,+,Uncharacterized
ABP140,YOR239W,15,784858,786745,1887,+,Verified
MET7,YOR241W,15,786996,788642,1646,+,Verified
SSP2,YOR242C,15,788743,789858,1115,-,Verified
PUS7,YOR243C,15,790212,792242,2030,-,Verified
ESA1,YOR244W,15,792532,793869,1337,+,Verified
DGA1,YOR245C,15,794077,795333,1256,-,Verified
YOR246C,YOR246C,15,795802,796794,992,-,Uncharacterized
SRL1,YOR247W,15,797677,798309,632,+,Verified
YOR248W,YOR248W,15,798014,798316,302,+,Dubious
APC5,YOR249C,15,798675,800732,2057,-,Verified
CLP1,YOR250C,15,800971,802308,1337,-,Verified
YOR251C,YOR251C,15,802551,803465,914,-,Uncharacterized
TMA16,YOR252W,15,803668,804204,536,+,Verified
NAT5,YOR253W,15,804378,804908,530,+,Verified
SEC63,YOR254C,15,805033,807024,1991,-,Verified
OSW1,YOR255W,15,807272,808108,836,+,Verified
TRE2,YOR256C,15,808254,810683,2429,-,Verified
CDC31,YOR257W,15,811008,811493,485,+,Verified
HNT3,YOR258W,15,811671,812324,653,+,Verified
RPT4,YOR259C,15,812395,813708,1313,-,Verified
GCD1,YOR260W,15,813984,815720,1736,+,Verified
RPN8,YOR261C,15,815915,816931,1016,-,Verified
YOR262W,YOR262W,15,817291,818334,1043,+,Verified
YOR263C,YOR263C,15,818756,819163,407,-,Dubious
DSE3,YOR264W,15,818865,820157,1292,+,Verified
RBL2,YOR265W,15,820453,820773,320,+,Verified
PNT1,YOR266W,15,821022,822293,1271,+,Verified
HRK1,YOR267C,15,822587,824866,2279,-,Verified
YOR268C,YOR268C,15,825533,825931,398,-,Uncharacterized
PAC1,YOR269W,15,826384,827868,1484,+,Verified
VPH1,YOR270C,15,828051,830573,2522,-,Verified
FSF1,YOR271C,15,831058,832041,983,-,Uncharacterized
YTM1,YOR272W,15,832812,834194,1382,+,Verified
TPO4,YOR273C,15,834451,836430,1979,-,Verified
MOD5,YOR274W,15,837673,838959,1286,+,Verified
RIM20,YOR275C,15,839083,841068,1985,-,Verified
CAF20,YOR276W,15,841332,841817,485,+,Verified
YOR277C,YOR277C,15,841514,841822,308,-,Dubious
HEM4,YOR278W,15,842816,843643,827,+,Verified
RFM1,YOR279C,15,843697,844629,932,-,Verified
FSH3,YOR280C,15,844991,845791,800,-,Verified
PLP2,YOR281C,15,846268,847128,860,-,Verified
YOR282W,YOR282W,15,846999,847319,320,+,Dubious
YOR283W,YOR283W,15,847452,848144,692,+,Uncharacterized
HUA2,YOR284W,15,848477,849208,731,+,Verified
YOR285W,YOR285W,15,849634,850053,419,+,Verified
AIM42,YOR286W,15,850279,850728,449,+,Uncharacterized
YOR287C,YOR287C,15,850936,851838,902,-,Uncharacterized
MPD1,YOR288C,15,852120,853076,956,-,Verified
YOR289W,YOR289W,15,853356,854111,755,+,Uncharacterized
SNF2,YOR290C,15,855146,860257,5111,-,Verified
YOR291W,YOR291W,15,861174,865592,4418,+,Uncharacterized
YOR292C,YOR292C,15,865652,866581,929,-,Uncharacterized
RPS10A,YOR293W,15,867097,867851,754,+,Verified
YOR293C-A,YOR293C-A,15,867997,868146,149,-,Uncharacterized
RRS1,YOR294W,15,868339,868950,611,+,Verified
UAF30,YOR295W,15,869207,869893,686,+,Verified
YOR296W,YOR296W,15,870201,874070,3869,+,Uncharacterized
TIM18,YOR297C,15,874742,875320,578,-,Verified
MUM3,YOR298W,15,875598,877037,1439,+,Verified
MBF1,YOR298C-A,15,877229,877684,455,-,Verified
BUD7,YOR299W,15,878433,880673,2240,+,Verified
YOR300W,YOR300W,15,880573,880881,308,+,Dubious
RAX1,YOR301W,15,880963,882270,1307,+,Verified
YOR302W,YOR302W,15,882763,882840,77,+,Verified
CPA1,YOR303W,15,882897,884132,1235,+,Verified
ISW2,YOR304W,15,884512,887874,3362,+,Verified
YOR304C-A,YOR304C-A,15,888518,888748,230,-,Uncharacterized
YOR305W,YOR305W,15,889020,889748,728,+,Uncharacterized
MCH5,YOR306C,15,889865,891430,1565,-,Verified
SLY41,YOR307C,15,892728,894089,1361,-,Verified
SNU66,YOR308C,15,894621,896384,1763,-,Verified
YOR309C,YOR309C,15,896695,897075,380,-,Dubious
NOP58,YOR310C,15,896822,898357,1535,-,Verified
DGK1,YOR311C,15,899053,899925,872,-,Verified
RPL20B,YOR312C,15,900247,901191,944,-,Verified
SPS4,YOR313C,15,901855,902871,1016,-,Verified
YOR314W,YOR314W,15,903040,903369,329,+,Dubious
YOR314W-A,YOR314W-A,15,904455,904565,110,+,Dubious
SFG1,YOR315W,15,904757,905797,1040,+,Verified
COT1,YOR316C,15,906233,907552,1319,-,Verified
YOR316C-A,YOR316C-A,15,907723,907932,209,-,Uncharacterized
FAA1,YOR317W,15,909340,911442,2102,+,Verified
YOR318C,YOR318C,15,911781,912433,652,-,Dubious
HSH49,YOR319W,15,912819,913460,641,+,Verified
GNT1,YOR320C,15,913616,915091,1475,-,Verified
PMT3,YOR321W,15,916027,918288,2261,+,Verified
LDB19,YOR322C,15,918603,921059,2456,-,Verified
PRO2,YOR323C,15,921532,922902,1370,-,Verified
FRT1,YOR324C,15,923229,925037,1808,-,Verified
YOR325W,YOR325W,15,924574,925047,473,+,Dubious
MYO2,YOR326W,15,925718,930442,4724,+,Verified
SNC2,YOR327C,15,930731,931078,347,-,Verified
PDR10,YOR328W,15,931800,936494,4694,+,Verified
SCD5,YOR329C,15,936728,939346,2618,-,Verified
YOR329W-A,YOR329W-A,15,939345,939554,209,+,Dubious
MIP1,YOR330C,15,939618,943382,3764,-,Verified
YOR331C,YOR331C,15,943562,944119,557,-,Dubious
VMA4,YOR332W,15,943653,944354,701,+,Verified
YOR333C,YOR333C,15,944538,944954,416,-,Dubious
MRS2,YOR334W,15,944593,946005,1412,+,Verified
ALA1,YOR335C,15,946230,949106,2876,-,Verified
YOR335W-A,YOR335W-A,15,946565,946645,80,+,Dubious
KRE5,YOR336W,15,949770,953867,4097,+,Verified
TEA1,YOR337W,15,954341,956620,2279,+,Verified
YOR338W,YOR338W,15,956895,957986,1091,+,Uncharacterized
UBC11,YOR339C,15,958359,958829,470,-,Verified
RPA43,YOR340C,15,959199,960179,980,-,Verified
RPA190,YOR341W,15,960984,965978,4994,+,Verified
YOR342C,YOR342C,15,966663,967622,959,-,Uncharacterized
YOR343C,YOR343C,15,968145,968471,326,-,Dubious
TYE7,YOR344C,15,977191,978066,875,-,Verified
YOR345C,YOR345C,15,981809,982159,350,-,Dubious
REV1,YOR346W,15,981825,984782,2957,+,Verified
PYK2,YOR347C,15,984939,986459,1520,-,Verified
PUT4,YOR348C,15,986896,988779,1883,-,Verified
CIN1,YOR349W,15,989786,992830,3044,+,Verified
MNE1,YOR350C,15,992861,994852,1991,-,Verified
MEK1,YOR351C,15,995015,996508,1493,-,Verified
YOR352W,YOR352W,15,997210,998241,1031,+,Uncharacterized
SOG2,YOR353C,15,998450,1000825,2375,-,Verified
MSC6,YOR354C,15,1001144,1003222,2078,-,Verified
GDS1,YOR355W,15,1005135,1006703,1568,+,Verified
YOR356W,YOR356W,15,1007219,1009114,1895,+,Verified
SNX3,YOR357C,15,1009222,1009710,488,-,Verified
HAP5,YOR358W,15,1010159,1010887,728,+,Verified
VTS1,YOR359W,15,1011187,1012758,1571,+,Verified
PDE2,YOR360C,15,1013239,1014819,1580,-,Verified
PRT1,YOR361C,15,1015359,1017650,2291,-,Verified
PRE10,YOR362C,15,1017878,1018744,866,-,Verified
PIP2,YOR363C,15,1020220,1023210,2990,-,Verified
YOR364W,YOR364W,15,1023369,1023737,368,+,Dubious
YOR365C,YOR365C,15,1023459,1025570,2111,-,Uncharacterized
YOR366W,YOR366W,15,1025254,1025607,353,+,Dubious
SCP1,YOR367W,15,1026005,1026607,602,+,Verified
RAD17,YOR368W,15,1026841,1028046,1205,+,Verified
RPS12,YOR369C,15,1028192,1028623,431,-,Verified
MRS6,YOR370C,15,1029181,1030992,1811,-,Verified
GPB1,YOR371C,15,1031487,1034180,2693,-,Verified
NDD1,YOR372C,15,1034805,1036469,1664,-,Verified
NUD1,YOR373W,15,1036832,1039387,2555,+,Verified
ALD4,YOR374W,15,1039838,1041397,1559,+,Verified
GDH1,YOR375C,15,1041676,1043040,1364,-,Verified
YOR376W,YOR376W,15,1043189,1043557,368,+,Dubious
YOR376W-A,YOR376W-A,15,1045194,1045349,155,+,Uncharacterized
ATF1,YOR377W,15,1046224,1047801,1577,+,Verified
YOR378W,YOR378W,15,1049509,1051056,1547,+,Uncharacterized
YOR379C,YOR379C,15,1050724,1051062,338,-,Dubious
RDR1,YOR380W,15,1051288,1052928,1640,+,Verified
FRE3,YOR381W,15,1055543,1057678,2135,+,Verified
YOR381W-A,YOR381W-A,15,1058421,1058588,167,+,Uncharacterized
FIT2,YOR382W,15,1059529,1059990,461,+,Verified
FIT3,YOR383C,15,1060439,1061053,614,-,Verified
FRE5,YOR384W,15,1061562,1063646,2084,+,Verified
YOR385W,YOR385W,15,1065041,1065913,872,+,Uncharacterized
PHR1,YOR386W,15,1066837,1068534,1697,+,Verified
YOR387C,YOR387C,15,1069619,1070239,620,-,Uncharacterized
FDH1,YOR388C,15,1071791,1072921,1130,-,Verified
YOR389W,YOR389W,15,1074211,1076085,1874,+,Uncharacterized
YOR390W,YOR390W,15,1076782,1077909,1127,+,Uncharacterized
HSP33,YOR391C,15,1078543,1079256,713,-,Verified
YOR392W,YOR392W,15,1079280,1079723,443,+,Dubious
ERR1,YOR393W,15,1080274,1081587,1313,+,Verified
PAU21,YOR394W,15,1082716,1083210,494,+,Uncharacterized
YOR394C-A,YOR394C-A,15,1084200,1084367,167,-,Uncharacterized
YRF1-8,YOR396W,15,1085471,1090861,5390,+,Uncharacterized
YOR396C-A,YOR396C-A,15,1090013,1090495,482,-,Dubious
YRF1-7,YPL283C,16,280,6007,5727,-,Verified
YPL283W-B,YPL283W-B,16,643,1125,482,+,Dubious
YPL283W-A,YPL283W-A,16,1426,2001,575,+,Dubious
PAU22,YPL282C,16,7933,8427,494,-,Uncharacterized
ERR2,YPL281C,16,9557,10870,1313,-,Verified
HSP32,YPL280W,16,11887,12600,713,+,Uncharacterized
YPL279C,YPL279C,16,13228,14355,1127,-,Uncharacterized
YPL278C,YPL278C,16,15053,15355,302,-,Uncharacterized
YPL277C,YPL277C,16,15405,16868,1463,-,Uncharacterized
SAM3,YPL274W,16,22938,24701,1763,+,Verified
SAM4,YPL273W,16,25087,26064,977,+,Verified
YPL272C,YPL272C,16,26611,28164,1553,-,Uncharacterized
ATP15,YPL271W,16,30079,30267,188,+,Verified
MDL2,YPL270W,16,30482,32803,2321,+,Verified
KAR9,YPL269W,16,33013,34947,1934,+,Verified
PLC1,YPL268W,16,35236,37845,2609,+,Verified
ACM1,YPL267W,16,38169,38798,629,+,Verified
DIM1,YPL266W,16,39121,40077,956,+,Verified
DIP5,YPL265W,16,41043,42869,1826,+,Verified
YPL264C,YPL264C,16,43283,44344,1061,-,Uncharacterized
KEL3,YPL263C,16,44551,46506,1955,-,Verified
FUM1,YPL262W,16,47336,48802,1466,+,Verified
YPL261C,YPL261C,16,48996,49304,308,-,Dubious
YPL260W,YPL260W,16,49303,50958,1655,+,Uncharacterized
APM1,YPL259C,16,51244,52671,1427,-,Verified
THI21,YPL258C,16,53498,55153,1655,-,Verified
YPL257W,YPL257W,16,63279,63860,581,+,Uncharacterized
CLN2,YPL256C,16,64977,66614,1637,-,Verified
BBP1,YPL255W,16,67725,68882,1157,+,Verified
HFI1,YPL254W,16,69485,70951,1466,+,Verified
VIK1,YPL253C,16,71063,73006,1943,-,Verified
YAH1,YPL252C,16,73363,73881,518,-,Verified
YPL251W,YPL251W,16,73625,73927,302,+,Dubious
ICY2,YPL250C,16,74309,74719,410,-,Verified
RPL36B,YPL249C-A,16,75699,76239,540,-,Verified
YPL250W-A,YPL250W-A,16,75702,75989,287,+,Dubious
GYP5,YPL249C,16,76669,79353,2684,-,Verified
GAL4,YPL248C,16,79711,82356,2645,-,Verified
YPL247C,YPL247C,16,82625,84196,1571,-,Uncharacterized
RBD2,YPL246C,16,84509,85297,788,-,Verified
YPL245W,YPL245W,16,85586,86950,1364,+,Uncharacterized
HUT1,YPL244C,16,87014,88033,1019,-,Verified
SRP68,YPL243W,16,88517,90316,1799,+,Verified
IQG1,YPL242C,16,90622,95109,4487,-,Verified
CIN2,YPL241C,16,95372,96258,886,-,Verified
HSP82,YPL240C,16,96496,98625,2129,-,Verified
YAR1,YPL239W,16,99484,100086,602,+,Verified
YPL238C,YPL238C,16,100474,100863,389,-,Dubious
SUI3,YPL237W,16,100496,101353,857,+,Verified
YPL236C,YPL236C,16,101608,102702,1094,-,Uncharacterized
RVB2,YPL235W,16,103232,104647,1415,+,Verified
TFP3,YPL234C,16,104946,105440,494,-,Verified
NSL1,YPL233W,16,106172,106822,650,+,Verified
SSO1,YPL232W,16,107275,108147,872,+,Verified
FAS2,YPL231W,16,108652,114315,5663,+,Verified
USV1,YPL230W,16,115219,116487,1268,+,Verified
YPL229W,YPL229W,16,117067,117687,620,+,Uncharacterized
CET1,YPL228W,16,118382,120031,1649,+,Verified
ALG5,YPL227C,16,120163,121167,1004,-,Verified
NEW1,YPL226W,16,121767,125357,3590,+,Verified
YPL225W,YPL225W,16,126006,126446,440,+,Verified
MMT2,YPL224C,16,126738,128087,1349,-,Verified
GRE1,YPL223C,16,128631,129137,506,-,Verified
FMP40,YPL222W,16,130161,132227,2066,+,Uncharacterized
YPL222C-A,YPL222C-A,16,131869,132114,245,-,Dubious
FLC1,YPL221W,16,133042,135423,2381,+,Verified
RPL1A,YPL220W,16,135789,136442,653,+,Verified
PCL8,YPL219W,16,136749,138227,1478,+,Verified
SAR1,YPL218W,16,138697,139408,711,+,Verified
BMS1,YPL217C,16,139619,143170,3551,-,Verified
YPL216W,YPL216W,16,143820,147128,3308,+,Uncharacterized
CBP3,YPL215W,16,147415,148422,1007,+,Verified
THI6,YPL214C,16,148568,150190,1622,-,Verified
LEA1,YPL213W,16,150613,151329,716,+,Verified
PUS1,YPL212C,16,151514,153148,1634,-,Verified
NIP7,YPL211W,16,153494,154039,545,+,Verified
SRP72,YPL210C,16,154289,156211,1922,-,Verified
IPL1,YPL209C,16,156489,157592,1103,-,Verified
RKM1,YPL208W,16,157841,159592,1751,+,Verified
TYW1,YPL207W,16,159908,162340,2432,+,Verified
PGC1,YPL206C,16,162631,163596,965,-,Uncharacterized
YPL205C,YPL205C,16,163921,164265,344,-,Dubious
HRR25,YPL204W,16,164275,165759,1484,+,Verified
TPK2,YPL203W,16,166255,167397,1142,+,Verified
AFT2,YPL202C,16,168087,169337,1250,-,Verified
YIG1,YPL201C,16,169769,171154,1385,-,Verified
CSM4,YPL200W,16,171483,171953,470,+,Verified
YPL199C,YPL199C,16,172032,172754,722,-,Uncharacterized
RPL7B,YPL198W,16,173151,174701,1550,+,Verified
YPL197C,YPL197C,16,174342,174755,413,-,Dubious
OXR1,YPL196W,16,175042,175863,821,+,Verified
APL5,YPL195W,16,176222,179020,2798,+,Verified
DDC1,YPL194W,16,179276,181114,1838,+,Verified
RSA1,YPL193W,16,181402,182547,1145,+,Verified
PRM3,YPL192C,16,182654,183055,401,-,Verified
YPL191C,YPL191C,16,183596,184678,1082,-,Uncharacterized
NAB3,YPL190C,16,185316,187724,2408,-,Verified
COA2,YPL189C-A,16,188306,188512,206,-,Uncharacterized
GUP2,YPL189W,16,189153,190982,1829,+,Verified
POS5,YPL188W,16,191405,192649,1244,+,Verified
MF(ALPHA)1,YPL187W,16,193647,194144,497,+,Verified
UIP4,YPL186C,16,194511,195425,914,-,Verified
YPL185W,YPL185W,16,195252,195647,395,+,Dubious
MRN1,YPL184C,16,195949,197787,1838,-,Uncharacterized
RTC6,YPL183W-A,16,199094,199375,281,+,Uncharacterized
RTT10,YPL183C,16,199494,202535,3041,-,Verified
YPL182C,YPL182C,16,203305,203688,383,-,Dubious
CTI6,YPL181W,16,203420,204940,1520,+,Verified
TCO89,YPL180W,16,205247,207646,2399,+,Verified
PPQ1,YPL179W,16,208156,209805,1649,+,Verified
CBC2,YPL178W,16,212157,212783,626,+,Verified
CUP9,YPL177C,16,213041,213961,920,-,Verified
TRE1,YPL176C,16,216011,218362,2351,-,Verified
SPT14,YPL175W,16,218629,220087,1458,+,Verified
NIP100,YPL174C,16,220166,222772,2606,-,Verified
MRPL40,YPL173W,16,223142,224035,893,+,Verified
COX10,YPL172C,16,224352,225740,1388,-,Verified
OYE3,YPL171C,16,226168,227370,1202,-,Verified
DAP1,YPL170W,16,228313,228771,458,+,Verified
MEX67,YPL169C,16,229038,230837,1799,-,Verified
YPL168W,YPL168W,16,231216,232508,1292,+,Uncharacterized
REV3,YPL167C,16,232592,237106,4514,-,Verified
ATG29,YPL166W,16,237337,237978,641,+,Verified
SET6,YPL165C,16,237955,239076,1121,-,Verified
MLH3,YPL164C,16,239349,241496,2147,-,Verified
SVS1,YPL163C,16,241917,242699,782,-,Verified
YPL162C,YPL162C,16,243205,244026,821,-,Uncharacterized
BEM4,YPL161C,16,244318,246219,1901,-,Verified
CDC60,YPL160W,16,246989,250261,3272,+,Verified
PET20,YPL159C,16,250906,251667,761,-,Verified
AIM44,YPL158C,16,252033,254309,2276,-,Uncharacterized
TGS1,YPL157W,16,254813,255760,947,+,Verified
PRM4,YPL156C,16,255912,256766,854,-,Verified
KIP2,YPL155C,16,257215,259335,2120,-,Verified
PEP4,YPL154C,16,259713,260930,1217,-,Verified
RAD53,YPL153C,16,261726,264191,2465,-,Verified
YPL152W-A,YPL152W-A,16,264601,264699,98,+,Uncharacterized
RRD2,YPL152W,16,265027,266103,1076,+,Verified
PRP46,YPL151C,16,266179,267534,1355,-,Verified
YPL150W,YPL150W,16,268187,270892,2705,+,Uncharacterized
ATG5,YPL149W,16,271309,272193,884,+,Verified
PPT2,YPL148C,16,272293,272814,521,-,Verified
PXA1,YPL147W,16,273254,275866,2612,+,Verified
NOP53,YPL146C,16,276161,277528,1367,-,Verified
KES1,YPL145C,16,278394,279698,1304,-,Verified
POC4,YPL144W,16,280479,280925,446,+,Verified
RPL33A,YPL143W,16,282121,282969,848,+,Verified
YPL142C,YPL142C,16,282685,283002,317,-,Dubious
YPL141C,YPL141C,16,283463,286060,2597,-,Uncharacterized
MKK2,YPL140C,16,287513,289033,1520,-,Verified
UME1,YPL139C,16,289668,291050,1382,-,Verified
SPP1,YPL138C,16,291365,292426,1061,-,Verified
GIP3,YPL137C,16,292816,296646,3830,-,Verified
YPL136W,YPL136W,16,296285,296653,368,+,Dubious
ISU1,YPL135W,16,297552,298049,497,+,Verified
YPL135C-A,YPL135C-A,16,297677,297850,173,-,Dubious
ODC1,YPL134C,16,298570,299502,932,-,Verified
RDS2,YPL133C,16,299887,301227,1340,-,Verified
COX11,YPL132W,16,301715,302617,902,+,Verified
RPL5,YPL131W,16,303120,304013,893,+,Verified
SPO19,YPL130W,16,304386,305057,671,+,Verified
TAF14,YPL129W,16,305297,306136,839,+,Verified
TBF1,YPL128C,16,306532,308220,1688,-,Verified
HHO1,YPL127C,16,308827,309603,776,-,Verified
NAN1,YPL126W,16,310209,312899,2690,+,Verified
KAP120,YPL125W,16,313387,316485,3098,+,Verified
SPC29,YPL124W,16,316754,317515,761,+,Verified
RNY1,YPL123C,16,317640,318944,1304,-,Verified
TFB2,YPL122C,16,319225,320766,1541,-,Verified
MEI5,YPL121C,16,320961,321629,668,-,Verified
VPS30,YPL120W,16,322070,323743,1673,+,Verified
YPL119C-A,YPL119C-A,16,324023,324286,263,-,Uncharacterized
DBP1,YPL119C,16,324410,326263,1853,-,Verified
MRP51,YPL118W,16,326627,327661,1034,+,Verified
IDI1,YPL117C,16,327863,328729,866,-,Verified
HOS3,YPL116W,16,329605,331698,2093,+,Verified
BEM3,YPL115C,16,332099,335485,3386,-,Verified
YPL114W,YPL114W,16,335947,336366,419,+,Dubious
YPL113C,YPL113C,16,335952,337142,1190,-,Uncharacterized
PEX25,YPL112C,16,337435,338619,1184,-,Verified
CAR1,YPL111W,16,339943,340944,1001,+,Verified
GDE1,YPL110C,16,341067,344738,3671,-,Verified
YPL109C,YPL109C,16,345263,347388,2125,-,Uncharacterized
YPL108W,YPL108W,16,348443,348949,506,+,Uncharacterized
YPL107W,YPL107W,16,349116,349862,746,+,Uncharacterized
SSE1,YPL106C,16,350191,352272,2081,-,Verified
SYH1,YPL105C,16,352860,355409,2549,-,Verified
MSD1,YPL104W,16,355697,357673,1976,+,Verified
FMP30,YPL103C,16,357997,359403,1406,-,Uncharacterized
YPL102C,YPL102C,16,360000,360302,302,-,Dubious
ELP4,YPL101W,16,360206,361576,1370,+,Verified
ATG21,YPL100W,16,361869,363359,1490,+,Verified
AIM43,YPL099C,16,363517,364065,548,-,Uncharacterized
MGR2,YPL098C,16,364383,364724,341,-,Verified
MSY1,YPL097W,16,364949,366427,1478,+,Verified
ERI1,YPL096C-A,16,366526,366732,206,-,Verified
PNG1,YPL096W,16,366924,368015,1091,+,Verified
EEB1,YPL095C,16,368068,369438,1370,-,Verified
SEC62,YPL094C,16,369836,370660,824,-,Verified
NOG1,YPL093W,16,370975,372918,1943,+,Verified
SSU1,YPL092W,16,373790,375166,1376,+,Verified
GLR1,YPL091W,16,375499,376950,1451,+,Verified
RPS6A,YPL090C,16,377288,378392,1104,-,Verified
RLM1,YPL089C,16,379117,381147,2030,-,Verified
YPL088W,YPL088W,16,381962,382990,1028,+,Uncharacterized
YDC1,YPL087W,16,383452,384405,953,+,Verified
ELP3,YPL086C,16,384770,386443,1673,-,Verified
SEC16,YPL085W,16,387064,393651,6587,+,Verified
BRO1,YPL084W,16,394035,396569,2534,+,Verified
SEN54,YPL083C,16,396699,398102,1403,-,Verified
MOT1,YPL082C,16,398477,404080,5603,-,Verified
RPS9A,YPL081W,16,404947,406041,1094,+,Verified
YPL080C,YPL080C,16,406169,406495,326,-,Dubious
RPL21B,YPL079W,16,406633,407536,903,+,Verified
ATP4,YPL078C,16,408007,408741,734,-,Verified
YPL077C,YPL077C,16,409365,410087,722,-,Uncharacterized
GPI2,YPL076W,16,410440,411282,842,+,Verified
GCR1,YPL075W,16,412251,415359,3108,+,Verified
YTA6,YPL074W,16,415760,418024,2264,+,Verified
YPL073C,YPL073C,16,418496,418981,485,-,Dubious
UBP16,YPL072W,16,418509,420008,1499,+,Verified
YPL071C,YPL071C,16,420045,420515,470,-,Uncharacterized
MUK1,YPL070W,16,420945,422783,1838,+,Verified
BTS1,YPL069C,16,422882,423889,1007,-,Verified
YPL068C,YPL068C,16,424212,425093,881,-,Uncharacterized
YPL067C,YPL067C,16,425248,425844,596,-,Uncharacterized
YPL066W,YPL066W,16,426230,427669,1439,+,Uncharacterized
VPS28,YPL065W,16,427924,428652,728,+,Verified
CWC27,YPL064C,16,428708,429613,905,-,Verified
TIM50,YPL063W,16,429936,431366,1430,+,Verified
YPL062W,YPL062W,16,431892,432296,404,+,Dubious
ALD6,YPL061W,16,432585,434087,1502,+,Verified
LPE10,YPL060W,16,434520,435761,1241,+,Verified
GRX5,YPL059W,16,444576,445028,452,+,Verified
PDR12,YPL058C,16,445839,450374,4535,-,Verified
SUR1,YPL057C,16,451906,453054,1148,-,Verified
YPL056C,YPL056C,16,453427,453732,305,-,Uncharacterized
LGE1,YPL055C,16,453989,454987,998,-,Verified
LEE1,YPL054W,16,455756,456661,905,+,Verified
KTR6,YPL053C,16,457115,458455,1340,-,Verified
OAZ1,YPL052W,16,458796,459675,879,+,Verified
ARL3,YPL051W,16,459960,460556,596,+,Verified
MNN9,YPL050C,16,460776,461963,1187,-,Verified
DIG1,YPL049C,16,462478,463836,1358,-,Verified
CAM1,YPL048W,16,464398,465645,1247,+,Verified
SGF11,YPL047W,16,465959,466258,299,+,Verified
ELC1,YPL046C,16,466641,466940,299,-,Verified
VPS16,YPL045W,16,467257,469653,2396,+,Verified
YPL044C,YPL044C,16,469923,470471,548,-,Dubious
NOP4,YPL043W,16,469936,471993,2057,+,Verified
SSN3,YPL042C,16,473037,474704,1667,-,Verified
YPL041C,YPL041C,16,475115,475738,623,-,Uncharacterized
ISM1,YPL040C,16,475990,478998,3008,-,Verified
YPL039W,YPL039W,16,479222,480172,950,+,Uncharacterized
YPL038W-A,YPL038W-A,16,480179,480370,191,+,Uncharacterized
MET31,YPL038W,16,480532,481065,533,+,Verified
EGD1,YPL037C,16,481425,481898,473,-,Verified
PMA2,YPL036W,16,482841,485684,2843,+,Verified
YPL035C,YPL035C,16,486562,486909,347,-,Dubious
YPL034W,YPL034W,16,486710,487207,497,+,Uncharacterized
YPL033C,YPL033C,16,487360,488205,845,-,Uncharacterized
SVL3,YPL032C,16,488885,491362,2477,-,Verified
PHO85,YPL031C,16,492016,493035,1019,-,Verified
TRM44,YPL030W,16,493541,495244,1703,+,Verified
SUV3,YPL029W,16,495504,497717,2213,+,Verified
ERG10,YPL028W,16,498094,499290,1196,+,Verified
SMA1,YPL027W,16,499663,500400,737,+,Verified
SKS1,YPL026C,16,500673,502181,1508,-,Verified
YPL025C,YPL025C,16,502471,503028,557,-,Dubious
RMI1,YPL024W,16,503515,504240,725,+,Verified
MET12,YPL023C,16,504337,506310,1973,-,Verified
RAD1,YPL022W,16,506695,509997,3302,+,Verified
ECM23,YPL021W,16,511099,511662,563,+,Verified
ULP1,YPL020C,16,512311,514176,1865,-,Verified
VTC3,YPL019C,16,514509,517016,2507,-,Verified
CTF19,YPL018W,16,517649,518758,1109,+,Verified
IRC15,YPL017C,16,518732,520231,1499,-,Verified
SWI1,YPL016W,16,521011,524955,3944,+,Verified
HST2,YPL015C,16,525807,526880,1073,-,Verified
YPL014W,YPL014W,16,527544,528689,1145,+,Uncharacterized
MRPS16,YPL013C,16,528982,529347,365,-,Verified
RRP12,YPL012W,16,529720,533406,3686,+,Verified
TAF3,YPL011C,16,533639,534700,1061,-,Verified
RET3,YPL010W,16,535015,535584,569,+,Verified
YPL009C,YPL009C,16,535817,538933,3116,-,Verified
CHL1,YPL008W,16,539382,541967,2585,+,Verified
TFC8,YPL007C,16,542079,543845,1766,-,Verified
NCR1,YPL006W,16,544628,548140,3512,+,Verified
AEP3,YPL005W,16,548483,550303,1820,+,Verified
LSP1,YPL004C,16,550629,551654,1025,-,Verified
ULA1,YPL003W,16,552017,553405,1388,+,Verified
SNF8,YPL002C,16,553624,554325,701,-,Verified
HAT1,YPL001W,16,554602,555726,1124,+,Verified
CIT3,YPR001W,16,556374,557834,1460,+,Verified
PDH1,YPR002W,16,558382,559932,1550,+,Verified
YPR002C-A,YPR002C-A,16,560566,560763,197,-,Dubious
YPR003C,YPR003C,16,561501,563765,2264,-,Uncharacterized
AIM45,YPR004C,16,564004,565038,1034,-,Verified
HAL1,YPR005C,16,565784,566668,884,-,Verified
ICL2,YPR006C,16,567266,568993,1727,-,Verified
REC8,YPR007C,16,569333,571375,2042,-,Verified
HAA1,YPR008W,16,573015,575099,2084,+,Verified
SUT2,YPR009W,16,576549,577355,806,+,Verified
RPA135,YPR010C,16,577582,581193,3611,-,Verified
YPR010C-A,YPR010C-A,16,582370,582731,361,-,Uncharacterized
YPR011C,YPR011C,16,583059,584039,980,-,Uncharacterized
YPR012W,YPR012W,16,584306,584560,254,+,Dubious
YPR013C,YPR013C,16,584629,585582,953,-,Uncharacterized
YPR014C,YPR014C,16,587186,587515,329,-,Dubious
YPR015C,YPR015C,16,590280,591023,743,-,Uncharacterized
TIF6,YPR016C,16,592329,593066,737,-,Verified
YPR016W-A,YPR016W-A,16,593093,593353,260,+,Dubious
DSS4,YPR017C,16,593483,593914,431,-,Verified
RLF2,YPR018W,16,594473,596293,1820,+,Verified
MCM4,YPR019W,16,596747,599548,2801,+,Verified
ATP20,YPR020W,16,599867,600214,347,+,Verified
AGC1,YPR021C,16,600646,603354,2708,-,Verified
YPR022C,YPR022C,16,603908,607309,3401,-,Uncharacterized
EAF3,YPR023C,16,608823,610028,1205,-,Verified
YME1,YPR024W,16,610478,612721,2243,+,Verified
CCL1,YPR025C,16,613374,614555,1181,-,Verified
ATH1,YPR026W,16,615376,619011,3635,+,Verified
YPR027C,YPR027C,16,620422,621255,833,-,Uncharacterized
YOP1,YPR028W,16,623524,624199,675,+,Verified
APL4,YPR029C,16,624466,626964,2498,-,Verified
CSR2,YPR030W,16,627877,631242,3365,+,Verified
NTO1,YPR031W,16,631512,633758,2246,+,Verified
SRO7,YPR032W,16,634120,637221,3101,+,Verified
HTS1,YPR033C,16,637376,639016,1640,-,Verified
ARP7,YPR034W,16,639522,640955,1433,+,Verified
GLN1,YPR035W,16,642205,643317,1112,+,Verified
VMA13,YPR036W,16,643833,645269,1436,+,Verified
YPR036W-A,YPR036W-A,16,645947,646150,203,+,Verified
ERV2,YPR037C,16,646445,647035,590,-,Verified
IRC16,YPR038W,16,646833,647192,359,+,Dubious
YPR039W,YPR039W,16,647009,647344,335,+,Dubious
TIP41,YPR040W,16,647302,648372,1070,+,Verified
TIF5,YPR041W,16,648701,649918,1217,+,Verified
PUF2,YPR042C,16,650432,653659,3227,-,Verified
RPL43A,YPR043W,16,654163,654844,681,+,Verified
OPI11,YPR044C,16,654521,654874,353,-,Dubious
MNI2,YPR045C,16,655137,656549,1412,-,Uncharacterized
MCM16,YPR046W,16,656796,657341,545,+,Verified
MSF1,YPR047W,16,657526,658935,1409,+,Verified
TAH18,YPR048W,16,659179,661050,1871,+,Verified
ATG11,YPR049C,16,661134,664670,3536,-,Verified
YPR050C,YPR050C,16,664950,665363,413,-,Dubious
MAK3,YPR051W,16,664957,665487,530,+,Verified
NHP6A,YPR052C,16,665690,665971,281,-,Verified
YPR053C,YPR053C,16,665785,666240,455,-,Dubious
SMK1,YPR054W,16,666277,667443,1166,+,Verified
SEC8,YPR055W,16,667673,670870,3197,+,Verified
TFB4,YPR056W,16,671123,672139,1016,+,Verified
BRR1,YPR057W,16,672468,673493,1025,+,Verified
YMC1,YPR058W,16,673748,674671,923,+,Verified
YPR059C,YPR059C,16,674311,674697,386,-,Dubious
ARO7,YPR060C,16,674858,675628,770,-,Verified
JID1,YPR061C,16,675974,676879,905,-,Verified
FCY1,YPR062W,16,677162,677638,476,+,Verified
YPR063C,YPR063C,16,677809,678317,508,-,Uncharacterized
YPR064W,YPR064W,16,678948,679367,419,+,Dubious
ROX1,YPR065W,16,679690,680796,1106,+,Verified
UBA3,YPR066W,16,681210,682109,899,+,Verified
ISA2,YPR067W,16,682217,682774,557,+,Verified
HOS1,YPR068C,16,682938,684350,1412,-,Verified
SPE3,YPR069C,16,684553,685434,881,-,Verified
MED1,YPR070W,16,685895,687595,1700,+,Verified
YPR071W,YPR071W,16,688169,688804,635,+,Uncharacterized
NOT5,YPR072W,16,690104,691786,1682,+,Verified
LTP1,YPR073C,16,691930,692415,485,-,Verified
TKL1,YPR074C,16,692793,694835,2042,-,Verified
YPR074W-A,YPR074W-A,16,695015,695185,170,+,Dubious
OPY2,YPR075C,16,695734,696816,1082,-,Verified
YPR076W,YPR076W,16,696473,696847,374,+,Dubious
YPR077C,YPR077C,16,697128,697499,371,-,Dubious
YPR078C,YPR078C,16,697144,698262,1118,-,Uncharacterized
MRL1,YPR079W,16,698867,700012,1145,+,Verified
TEF1,YPR080W,16,700592,701968,1376,+,Verified
GRS2,YPR081C,16,702112,703968,1856,-,Verified
DIB1,YPR082C,16,704223,704654,431,-,Verified
MDM36,YPR083W,16,704852,706591,1739,+,Verified
YPR084W,YPR084W,16,706970,708340,1370,+,Uncharacterized
YPR085C,YPR085C,16,708495,709826,1331,-,Uncharacterized
SUA7,YPR086W,16,710099,711136,1037,+,Verified
VPS69,YPR087W,16,711352,711672,320,+,Dubious
SRP54,YPR088C,16,711401,713026,1625,-,Verified
YPR089W,YPR089W,16,713273,715939,2666,+,Uncharacterized
YPR091C,YPR091C,16,716154,718466,2312,-,Verified
YPR092W,YPR092W,16,718377,718682,305,+,Dubious
ASR1,YPR093C,16,719556,720422,866,-,Verified
RDS3,YPR094W,16,720635,720958,323,+,Verified
SYT1,YPR095C,16,721035,724715,3680,-,Verified
YPR096C,YPR096C,16,724840,725142,302,-,Verified
YPR097W,YPR097W,16,725392,728613,3221,+,Verified
YPR098C,YPR098C,16,728945,729526,581,-,Verified
YPR099C,YPR099C,16,729755,730111,356,-,Dubious
MRPL51,YPR100W,16,729789,730211,422,+,Verified
SNT309,YPR101W,16,730490,731017,527,+,Verified
RPL11A,YPR102C,16,731222,731746,524,-,Verified
PRE2,YPR103W,16,732347,733210,863,+,Verified
FHL1,YPR104C,16,733621,736431,2810,-,Verified
COG4,YPR105C,16,736982,739567,2585,-,Verified
ISR1,YPR106W,16,740059,741390,1331,+,Verified
YTH1,YPR107C,16,741436,742062,626,-,Verified
RPN7,YPR108W,16,742452,743741,1289,+,Verified
YPR108W-A,YPR108W-A,16,744173,744385,212,+,Uncharacterized
YPR109W,YPR109W,16,744687,745571,884,+,Uncharacterized
RPC40,YPR110C,16,745826,746833,1007,-,Verified
DBF20,YPR111W,16,747304,748998,1694,+,Verified
MRD1,YPR112C,16,749254,751917,2663,-,Verified
PIS1,YPR113W,16,752255,752917,662,+,Verified
YPR114W,YPR114W,16,753299,754246,947,+,Uncharacterized
GCA1,YPR115W,16,754875,758126,3251,+,Uncharacterized
YPR116W,YPR116W,16,758646,759479,833,+,Uncharacterized
YPR117W,YPR117W,16,760023,767492,7469,+,Uncharacterized
MRI1,YPR118W,16,767750,768985,1235,+,Verified
CLB2,YPR119W,16,771651,773126,1475,+,Verified
CLB5,YPR120C,16,773873,775180,1307,-,Verified
THI22,YPR121W,16,778579,780297,1718,+,Verified
AXL1,YPR122W,16,782041,785667,3626,+,Verified
YPR123C,YPR123C,16,786137,786571,434,-,Dubious
CTR1,YPR124W,16,786204,787424,1220,+,Verified
YLH47,YPR125W,16,787957,789321,1364,+,Verified
YPR126C,YPR126C,16,789073,789381,308,-,Dubious
YPR127W,YPR127W,16,790079,791116,1037,+,Uncharacterized
ANT1,YPR128C,16,791214,792200,986,-,Verified
SCD6,YPR129W,16,792683,793732,1049,+,Verified
YPR130C,YPR130C,16,793370,793777,407,-,Dubious
NAT3,YPR131C,16,793907,794494,587,-,Verified
RPS23B,YPR132W,16,794961,795763,802,+,Verified
SPN1,YPR133C,16,795974,797206,1232,-,Verified
TOM5,YPR133W-A,16,797553,797705,152,+,Verified
MSS18,YPR134W,16,798047,798853,806,+,Verified
CTF4,YPR135W,16,799230,802013,2783,+,Verified
YPR136C,YPR136C,16,802321,802833,512,-,Dubious
RRP9,YPR137W,16,802355,804076,1721,+,Verified
MEP3,YPR138C,16,810980,812449,1469,-,Verified
VPS66,YPR139C,16,813152,814054,902,-,Verified
TAZ1,YPR140W,16,814387,815532,1145,+,Verified
KAR3,YPR141C,16,815730,817919,2189,-,Verified
YPR142C,YPR142C,16,818126,818689,563,-,Dubious
RRP15,YPR143W,16,818319,819071,752,+,Verified
NOC4,YPR144C,16,819761,821419,1658,-,Verified
ASN1,YPR145W,16,822616,824334,1718,+,Verified
YPR145C-A,YPR145C-A,16,824686,824922,236,-,Uncharacterized
YPR146C,YPR146C,16,825343,825672,329,-,Dubious
YPR147C,YPR147C,16,825641,826555,914,-,Uncharacterized
YPR148C,YPR148C,16,826829,828136,1307,-,Verified
NCE102,YPR149W,16,829914,830435,521,+,Verified
YPR150W,YPR150W,16,830995,831516,521,+,Dubious
SUE1,YPR151C,16,831051,831671,620,-,Verified
URN1,YPR152C,16,832057,833454,1397,-,Uncharacterized
YPR153W,YPR153W,16,833685,834241,556,+,Verified
PIN3,YPR154W,16,834561,835208,647,+,Verified
NCA2,YPR155C,16,835559,837409,1850,-,Verified
TPO3,YPR156C,16,837905,839773,1868,-,Verified
YPR157W,YPR157W,16,841262,842665,1403,+,Uncharacterized
YPR158W,YPR158W,16,843258,844016,758,+,Uncharacterized
KRE6,YPR159W,16,857579,859741,2162,+,Verified
YPR159C-A,YPR159C-A,16,860310,860411,101,-,Uncharacterized
GPH1,YPR160W,16,861302,864010,2708,+,Verified
YPR160W-A,YPR160W-A,16,861930,862010,80,+,Dubious
YPR160C-A,YPR160C-A,16,862573,862857,284,-,Dubious
SGV1,YPR161C,16,864445,866418,1973,-,Verified
ORC4,YPR162C,16,866711,868300,1589,-,Verified
TIF3,YPR163C,16,868641,869951,1310,-,Verified
MMS1,YPR164W,16,870699,874922,4223,+,Verified
RHO1,YPR165W,16,875364,875993,629,+,Verified
MRP2,YPR166C,16,876278,876625,347,-,Verified
MET16,YPR167C,16,876843,877628,785,-,Verified
NUT2,YPR168W,16,878072,878545,473,+,Verified
JIP5,YPR169W,16,878686,880164,1478,+,Uncharacterized
YPR170C,YPR170C,16,882979,883314,335,-,Dubious
YPR169W-A,YPR169W-A,16,883235,883453,218,+,Dubious
YPR170W-B,YPR170W-B,16,883235,883591,356,+,Uncharacterized
YPR170W-A,YPR170W-A,16,883374,883559,185,+,Dubious
BSP1,YPR171W,16,883824,885554,1730,+,Verified
YPR172W,YPR172W,16,885792,886394,602,+,Uncharacterized
VPS4,YPR173C,16,886520,887833,1313,-,Verified
YPR174C,YPR174C,16,888039,888704,665,-,Uncharacterized
DPB2,YPR175W,16,888970,891039,2069,+,Verified
BET2,YPR176C,16,891097,892074,977,-,Verified
YPR177C,YPR177C,16,892309,892680,371,-,Dubious
PRP4,YPR178W,16,892328,893725,1397,+,Verified
HDA3,YPR179C,16,893793,895760,1967,-,Verified
AOS1,YPR180W,16,895957,897000,1043,+,Verified
SEC23,YPR181C,16,897357,899663,2306,-,Verified
SMX3,YPR182W,16,900190,900450,260,+,Verified
DPM1,YPR183W,16,900751,901554,803,+,Verified
GDB1,YPR184W,16,902040,906650,4610,+,Verified
ATG13,YPR185W,16,907214,909430,2216,+,Verified
PZF1,YPR186C,16,909729,911018,1289,-,Verified
RPO26,YPR187W,16,911253,911796,543,+,Verified
MLC2,YPR188C,16,911984,912475,491,-,Verified
SKI3,YPR189W,16,912660,916958,4298,+,Verified
RPC82,YPR190C,16,917073,919037,1964,-,Verified
QCR2,YPR191W,16,919377,920483,1106,+,Verified
AQY1,YPR192W,16,921856,922773,917,+,Verified
HPA2,YPR193C,16,922905,923375,470,-,Verified
OPT2,YPR194C,16,924300,926933,2633,-,Verified
YPR195C,YPR195C,16,927961,928290,329,-,Dubious
YPR196W,YPR196W,16,931372,932784,1412,+,Uncharacterized
YPR197C,YPR197C,16,933894,934457,563,-,Dubious
SGE1,YPR198W,16,934030,935661,1631,+,Verified
ARR1,YPR199C,16,938144,939028,884,-,Verified
ARR2,YPR200C,16,939275,939667,392,-,Verified
ARR3,YPR201W,16,939918,941132,1214,+,Verified
YPR202W,YPR202W,16,943028,943892,864,+,Uncharacterized
YPR203W,YPR203W,16,943876,944184,308,+,Uncharacterized
YPR204W,YPR204W,16,944599,947697,3098,+,Uncharacterized
YPR204C-A,YPR204C-A,16,946852,947334,482,-,Dubious
